Fire=Oheň
Water=Voda
Air=Vzduch
Earth=Země
Ocean=Oceán
Lava=Láva
Volcano=Vulkán
Pressure=Tlak
Ash=Popel
Stone=Kámen
Metal=Kov
Wind=Vítr
Swamp=Bažina
Energy=Energie
Life=Život
Algae=Řasa
Bacteria=Bakterie
Worm=Červ
Sulfur=Síra
Ghost=Duch
Steam=Pára
Sand=Písek
Dust=Prach
Gunpowder=Střelný prach
Mud=Bahno
Mite=Roztoč
Seed=Semena
Clay=Hlína
Glass=Sklo
Snake=Had
Beach=Pláž
Desert=Poušť
Silicon=Silikon
Hourglass=Přesýpací hodiny
Tree=Strom
Egg=Vejce
Lizard=Ještěrka
Beast=Zvíře
Monkey=Opice
Man=Člověk
Grove=Háj
Forest=Les
Tool=Nářadí
Livestock=Dobytek
Bear=Medvěd
Panda=Panda
Shark=Žralok
Bird=Pták
Omelette=Omeleta
Turtle=Želva
Tortoise=Želvička
Fish=Ryba
Caviar=Kaviár
Dinosaur=Dinosaur
Chicken=Kuře
Transistor=Transistor
Chip=Čip
Computer=Počítač
Radio=Rádio
Radar=Radar
Ice=Led
PolarBear=Polární medvěd
Hippopotamus=Hroch
Tornado=Tornádo
Storm=Bouře
Cloud=Mrak
Sky=obloha
Rain=Déšť
Thunderstorm=Hromobití
Snow=Sníh
Electricity=Elektřina
Lightbulb=Žárovka
Light=Světlo
Rainbow=Duha
Sun=Slunce
Penguin=Tučňák
Brick=Cihla
Beetle=Brouk
Mushroom=Houba
Flower=Kvìtina
Fruit=ovoce
Watermelon=Vodní meloun
Moon=Měsíc
Planet=Planeta
Solarsystem=Solarní systém
Galaxy=Galaxie
Universe=Vesmír
Butterfly=Motýl
Fly=Moucha
Dragonfly=Vážka
Plesiosaur=Plesiosaur
Pterosaur=Pterosaur
Dragon=Drak
Tiger=Tigr
Star=Hvězda
Starfish=Hvězdice
Arm=Zbraň
Lightsaber=Světelný meč
Firearm=Střelná zbraň
Hunter=Lovec
Warrior=Válečník
Soldier=Voják
Cactus=Kaktus
Fisherman=Rybář
Poison=Jed
Lichen=Lišejník
Corpse=Mrtvola
Fugu=Fugu
Assassin=Vrah
Sith=Sith
Jedi=Jedi
DarthVader=Darth Vader
Poisonedweapon=Jedovaté zbraně
Plankton=Plankton
Whale=Velryba
Shell=Mušle
Limestone=Vápenec
Pearl=Perla
Snail=Hlemýžï
Lime=Vápno
Cement=Cement
Concrete=Beton
Mold=Plíseň
Cheese=Sýr
Mouse=Myš
Cat=Kočka
TomandJerry=Tom and Jerry
Fondue=Fondue
Moss=Mech
Fern=Kapradina
Fossil=Zkamenělina
Grass=Tráva
Milk=Mléko
Manure=Hnůj
Yogurt=Jogurt
Flu=Chřipka
Ozone=Ozon
Airplane=Letadlo
Arable=Ornice
Geyser=Gejzír
Wheat=Obilí
Flour=Mouka
Dough=Těsto
Bread=Chleba
Pizza=Pizza
Pie=Koláč
Kerogen=Kerogen
Bitumen=Bitumen
Petroleum=Ropa
Gasoline=Benzín
Scorpion=Škorpion
Cochineal=Cochineal
Carmine=Karmínová červeň
Scarab=Scarab
TheBeatles=The Beatles
Wheel=Kolo
Bicycle=Jízdní kolo
Wagon=Vagón
Coal=Uhlí
Uncutdiamond=Surový diamant
Diamond=Diamant
Boiler=Kotel
Steamengine=Parní stroj
Combustionengine=Spalovací motor
Locomotive=Lokomotiva
Car=Auto
Motorcycle=Motorcykl
Motorboat=Motorový člun
Boat=Loď
Woodenship=Dřevěná loď
Steamer=Parník
Wood=Dřevo
Coffin=Rakev
Pinocchio=Pinocchio
Grape=Hrozny
Yeast=Kvasinky
Alcohol=Alkohol
Wine=Víno
Beer=Pivo
Tequila=Tequila
Vodka=Vodka
Perfume=Parfém
Paper=Papír
Book=Kniha
Library=Knihovna
Hut=Chata
House=Dům
Skyscraper=Mrakodrap
City=Město
Country=Stát
Continent=Kontinent
Time=Čas
Oldman=Stařec
Christmastree=Vánoční stromek
Santaclaus=Santa claus
Snowman=Sněhulák
Scientist=Vědec
Penicillin=Penicilin
Meat=Maso
Wool=Vlna
Cloth=Plátno
Clothing=Oblečení
Knife=Nůž
Scissors=Nůžky
Hydrogen=Vodík
Oxygen=Kyslík
Carbondioxide=Oxyd uhličitý
Sodawater=Sodovka
CocaCola=Coca Cola
Barbeque=Grilované maso
Mummy=Můmie
Pyramid=Pyramida
Anubis=Anubis
Pharaoh=Faraón
Zombie=Zombie
Frankenstein=Frankenstein
Grave=Hrob
Cemetery=Hřbitov
Blood=Krev
Sailboat=Plachetnice
Sick=Nemoc
Hospital=Nemocnice
Museum=Muzeum
Bar=Bar
Zoo=Zoo
Feather=Peří
Pillow=Polštář
Quetzalcoatl=Quetzalcoatl
Bat=Netopýr
Batman=Batman
Vampire=Vampír
Werewolf=Vlkodlak
TwilightSaga=Twilight Sága
Sex=Sex
SexandtheCity=Sex ve městě
Kamasutra=Kamasutra
Chariot=Dvoukolák
Berry=Bobule
Hencoop=Kurník
Avianflu=Ptačí chřipka
Pig=Prase
Swineflu=Prasečí chřipka
Bacon=Slanina
Soap=Mýdlo
Jungle=Džungle
JungleBook=Kniha džunglí
Hero=Hrdina
RobinHood=Robin Hood
Submarine=Ponorka
CaptainNemo=Kapitán Nemo
Island=Ostrov
Fat=Tuk
Pilot=Pilot
Captain=Kapitán
Pirate=Pirát
Pirateship=Pirátská loď
Treasure=Poklad
Love=Láska
Sandwich=Sendvič
McDonalds=McDonalds
Bow=Luk
Dam=Přehrada
Beaver=Bobr
Champagne=Sekt
Ceramics=Keramika
Ectoplasm=Ektoplasma
Reed=Rákos
Tobacco=Tabák
Cigarettes=Cigarety
Cancer=Rakovina
Smoke=Kouř
Alchemist=Alchymista
Gold=Zlato
Radioactivity=Radioaktivita
Uranium=Uran
Plutonium=Plutonium
Atomicbomb=Atomová bomba
Hydrogenbomb=Vodíková puma
Alien=Vetřelec
Starship=Vesmírná loď
CaptainPicard=Kapitán Picard
USSEnterprise=USS Enterprise
Supernova=Supernova
Blackhole=Černá díra
Wormhole=Červí díra
Void=Prázdnota
BigBang=Velký třesk
BigCrunch=Velká imploze
Idea=Myšlenka
StephenHawking=Stephen Hawking
AlbertEinstein=Albert Einstein
Relativitytheory=Teorie relativity
Lamp=Lampa
Lavalamp=Lávová lampa
Genie=Džin
Prisoner=Vězeň
Coral=Korál
VWBeetle=VW Brouk
Toast=Toust
Explosion=Explose
OneUP=1UP
Mario=Mario
Yoshi=Yoshi
Yoshiegg=Yoshiho vejce
Team=Tým
Boomushroom=Boo mushroom
Computergame=Počítačová hra
Luigi=Luigi
King=Král
Leach=Pijavice
LichKing=Král mrtvých
Warcraft=Warcraft
Fireelemental=Ohnivý Elementál
Ant=Mravenec
Termite=Termit
Insects=Hmyz
Mosquito=Komár
Mantis=Kudlanka
Infestation=Zamoření
Robot=Robot
Zerg=Zerg
Protoss=Protoss
Terran=Terran
Starcraft=Starcraft
QueenofBlades=Královna ostří
Zeratul=Zeratul
JimRaynor=Jim Raynor
NeedforSpeed=Need for Speed
ResidentEvil=Resident Evil
TombRaider=Tomb Raider
LaraCroft=Lara Croft
Paint=Barva
Fabergeegg=Fabergské vejce
Easteregg=Kraslice
Lighthouse=Maják
Frog=Žába
Salamander=Salamandr
Diet=Dieta
Obesity=Obesita
Rust=Rez
Phoenix=Fénix
Sniper=Odstřelovač
Sushi=Sushi
Vulture=Sup
Weevil=Nosatec
Undead=Nemrtvý
Vinegar=Ocet
Spinningwheel=Kolovrat
Yarn=Příze
Aluminium=Hliník
Kangaroo=Klokan
Russia=Rusko
Romania=Rumunsko
USA=USA
France=Francie
Germany=Německo
UK=Velká Británie
China=Čína
Egypt=Egypt
Italy=Itálie
SouthAfrica=Jihoafrická republika
Mexico=Mexiko
India=Indie
Japan=Japonsko
Iceland=Island
Switzerland=Švýcarsko
Australia=Austrálie
Dracula=Dracula
Somalia=Somálsko
SaudiArabia=Saudská Arábie
Napoleon=Napoleon
Antarctica=Antarktida
Brazil=Brazílie
Canada=Kanada
Norway=Norsko
KarelCapek=Karel Čapek
CzechRepublic=Česká republika
Sauna=Sauna
Finland=Finsko
Netherlands=Nizozemí
Alcoholic=Alkoholik
Ashtray=Popelník
Tropics=Tropy
SugarCane=Cukrová třtina
Sugar=Cukr
Caramel=Karamel
Clock=Hodiny
Firefighter=Hasič
Firefly=Světluška
Juice=Džus
LightningRod=Hromosvod
Mirror=Zrcadlo
Peat=Rašelina
SwissArmyKnife=Švícarský nůž
ScotchWhiskey=Skotská whiskey
Scotland=Skotsko
Samurai=Samurai
Rubber=Guma
Ball=Míč
Football=Fotbal
StarWars=Hvězdné války
R2D2=R2D2
C3PO=C3P0
Lobster=Humr
Camel=Velbloud
Statue=Socha
Monument=Monument
LibertyStatue=Socha svobody
EiffelTower=Eiffelovka
Colosseum=Colosseum
BigBen=Big Ben
TajMahal=Taj Mahal
Playcards=Hrací karty
Jellyfish=Medúza
Ambulance=Ambulance
Sound=Zvuk
Music=Hudba
Guitar=Kytara
GuitarHero=Guitar hero
Sport=Sport
F1=Formule 1
Gymnastics=Gymnastika
TableTennis=Stolní tenis
AmericanFootball=Americký fotbal
Hockey=Hokej
Rugby=Rugby
Ferrari=Ferrari
Ford=Ford
Mercedes=Mercedes
Audi=Audi
BWM=BMW
Renault=Renault
Nissan=Nissan
Toyota=Toyota
Cricket=Cricket
ManUtd=Manchester United
Chelsea=Chelsea
Arsenal=Arsenal
Liverpool=Liverpool
Picture=Obrázek
Camera=Fotoaparát
Movie=Film
Theater=Divadlo
Oscar=Oscar
Linux=Linux
Artist=Umělec
Hail=Kroupa
Airport=Letiště
Geek=Kejklíř
Nerd=Hlupák
Blowfish=Ježík
Musician=Muzikant
Astronaut=Astronaut
Science=Vědec
Chemistry=Chemie
Biology=Biologie
Physics=Fyzika
Geology=Geologie
Paleontology=Paleontologie
Astronomy=Astronomie
CharlesDarwin=Charles Darwin
MobyDick=Moby Dick
Chalk=Křída
Blackboard=Tabule
Student=Student
School=Škola
Schoolbus=Školní autobus
Soundofmusic=Hudba
Money=Peníze
Economy=Ekonomie
Economics=Ekonomika
Dollar=Dolar
Euro=Euro
Pound=Libra
Europe=Europa
Bank=Banka
Vault=Trezor
Plastic=Plast
Creditcard=Kreditní karta
Box=Box
Container=Kontejner
Cargo=Náklad
Safe=Sejf
Depositbox=Depositní schránka
Toolbox=Nástroje
Basket=Koš
Basketball=Košíková
Helmet=Helmet
Work=Práce
Worker=Dělník
Company=Společnost
Factory=Továrna
Product=Výrobek
Christmas=Vánoce
Gift=Dárek
Giftbox=Dárková krabice
Soundmixer=Mixážní pult
Speakers=Reproduktor
Language=Jazyk
Linguistics=Lingvistika