Fire=Ild
Water=Vand
Air=Luft
Earth=Jord
Ocean=Ocean
Lava=Lava
Volcano=Vulkan
Pressure=Tryk
Ash=Aske
Stone=Sten
Metal=Metal
Wind=Vind
Swamp=Sump
Energy=Energi
Life=Liv
Algae=Alger
Bacteria=Bakterier
Worm=Orm
Sulfur=Svovl
Ghost=Spøgelse
Steam=Damp
Sand=Sand
Dust=Støv
Gunpowder=Krudt
Mud=Mudder
Mite=Mide
Seed=Frø
Clay=Ler
Glass=Glas
Snake=Slange
Beach=Strand
Desert=Ørken
Silicon=Silicium
Hourglass=Timeglas
Tree=Træ
Egg=Æg
Lizard=Øgle
Beast=Dyr
Monkey=Abe
Man=Menneske
Grove=Lund
Forest=Skov
Tool=Værktøj
Livestock=Husdyr
Bear=Bjørn
Panda=Panda
Shark=Haj
Bird=Fugl
Omelette=Omelet
Turtle=Skildpadde
Tortoise=Landskildpadde
Fish=Fisk
Caviar=Kaviar
Dinosaur=Dinosaur
Chicken=Høne
Transistor=Transistor
Chip=Chip
Computer=Computer
Radio=Radio
Radar=Radar
Ice=Is
PolarBear=Isbjørn
Hippopotamus=Flodhest
Tornado=Tornado
Storm=Storm
Cloud=Sky
Sky=Himmel
Rain=Regn
Thunderstorm=Tordenvejr
Snow=Sne
Electricity=Elektricitet
Lightbulb=Elpære
Light=Lys
Rainbow=Regnbue
Sun=Sol
Penguin=Pingvin
Brick=Mursten
Beetle=Bille
Mushroom=Svamp
Flower=Blomst
Fruit=Frugt
Watermelon=Vandmelon
Moon=Måne
Planet=Planet
Solarsystem=Solsystem
Galaxy=Galakse
Universe=Univers
Butterfly=Sommerfugl
Fly=Flue
Dragonfly=Guldsmed
Plesiosaur=Plesiosaur
Pterosaur=Pterosaur
Dragon=Drage
Tiger=Tiger
Star=Stjerne
Starfish=Søstjerne
Arm=Våben
Lightsaber=Lyssværd
Firearm=Skydevåben
Hunter=Jæger
Warrior=Kriger
Soldier=Soldat
Cactus=Kaktus
Fisherman=Fisker
Poison=Gift
Lichen=Lav
Corpse=Lig
Fugu=Kuglefisk
Assassin=Snigmorder
Sith=Sith
Jedi=Jedi
DarthVader=Darth Vader
Poisonedweapon=Forgiftet våben
Plankton=Plankton
Whale=Hval
Shell=Skal
Limestone=Kalksten
Pearl=Perle
Snail=Snegl
Lime=Kalk
Cement=Cement
Concrete=Beton
Mold=Mug
Cheese=Ost
Mouse=Mus
Cat=Kat
TomandJerry=Tom og Jerry
Fondue=Fondue
Moss=Mos
Fern=Bregne
Fossil=Fossil
Grass=Græs
Milk=Mælk
Manure=Møg
Yogurt=Yoghurt
Flu=Influenza
Ozone=Ozon
Airplane=Fly
Arable=Mark
Geyser=Gejser
Wheat=Hvede
Flour=Mel
Dough=Dej
Bread=Brød
Pizza=Pizza
Pie=Tærte
Kerogen=Kerogen
Bitumen=Bitumen
Petroleum=Petroleum
Gasoline=Benzin
Scorpion=Skorpion
Cochineal=Cochenillelus
Carmine=Karminsyre
Scarab=Skarabæ
TheBeatles=The Beatles
Wheel=Hjul
Bicycle=Cykel
Wagon=Vogn
Coal=Kul
Uncutdiamond=Usleben diamant
Diamond=Diamant
Boiler=Keddel
Steamengine=Dampmaskine
Combustionengine=Eksplosionsmotor
Locomotive=Lokomotiv
Car=Bil
Motorcycle=Motorcykel
Motorboat=Motorbåd
Boat=Båd
Woodenship=Træskib
Steamer=Damper
Wood=Planke
Coffin=Kiste
Pinocchio=Pinocchio
Grape=Drue
Yeast=Gær
Alcohol=Alkohol
Wine=Vin
Beer=Øl
Tequila=Tequila
Vodka=Vodka
Perfume=Parfume
Paper=Papir
Book=Bog
Library=Bibliotek
Hut=Hytte
House=Hus
Skyscraper=Skyskraber
City=By
Country=Land
Continent=Kontinent
Time=Tid
Oldman=Gammel mand
Christmastree=Juletræ
Santaclaus=Julemanden
Snowman=Snemand
Scientist=Videnskabsmand
Penicillin=Penicillin
Meat=Kød
Wool=Uld
Cloth=Stof
Clothing=Tøj
Knife=Kniv
Scissors=Saks
Hydrogen=Brint
Oxygen=Ilt
Carbondioxide=Kuldioxid
Sodawater=Sodavand
CocaCola=Coca Cola
Barbeque=Barbeque
Mummy=Mumie
Pyramid=Pyramide
Anubis=Anubis
Pharaoh=Farao
Zombie=Zombie
Frankenstein=Frankenstein
Grave=Grav
Cemetery=Kirkegård
Blood=Blod
Sailboat=Sejlbåd
Sick=Syg
Hospital=Hospital
Museum=Museum
Bar=Bar
Zoo=Zoologisk have
Feather=Fjer
Pillow=Pude
Quetzalcoatl=Quetzalcoatl
Bat=Flagermus
Batman=Batman
Vampire=Vampyr
Werewolf=Varulv
TwilightSaga=Twilight Saga
Sex=Sex
SexandtheCity=Sex and the City
Kamasutra=Kamasutra
Chariot=Stridsvogn
Berry=Bær
Hencoop=Hønsehus
Avianflu=Fugleinfluenza
Pig=Svin
Swineflu=Svineinfluenza
Bacon=Bacon
Soap=Sæbe
Jungle=Jungle
JungleBook=Junglebogen
Hero=Helt
RobinHood=Robin Hood
Submarine=Ubåd
CaptainNemo=Kaptajn Nemo
Island=Ø
Fat=Fed
Pilot=Pilot
Captain=Kaptajn
Pirate=Pirat
Pirateship=Piratskib
Treasure=Skat
Love=Kærlighed
Sandwich=Sandwich
McDonalds=McDonalds
Bow=Bue
Dam=Dæmning
Beaver=Bæver
Champagne=Champagne
Ceramics=Keramik
Ectoplasm=Ektoplasma
Reed=Siv
Tobacco=Tobak
Cigarettes=Cigaretter
Cancer=Kræft
Smoke=Røg
Alchemist=Alkymist
Gold=Guld
Radioactivity=Radioaktivitet
Uranium=Uran
Plutonium=Plutonium
Atomicbomb=Atombombe
Hydrogenbomb=Brintbombe
Alien=Alien
Starship=Stjerneskib
CaptainPicard=Kaptajn Picard
USSEnterprise=USS Enterprise
Supernova=Supernova
Blackhole=Sort hul
Wormhole=Ormehul
Void=Tomrum
BigBang=Big Bang
BigCrunch=Big Crunch
Idea=Idé
StephenHawking=Stephen Hawking
AlbertEinstein=Albert Einstein
Relativitytheory=Relativitetsteori
Lamp=Lampe
Lavalamp=Lavalampe
Genie=Ånd
Prisoner=Fange
Coral=Koral
VWBeetle=VW Boble
Toast=Toast
Explosion=Eksplosion
OneUP=1UP
Mario=Mario
Yoshi=Yoshi
Yoshiegg=Yoshi egg
Team=Hold
Boomushroom=Boo mushroom
Computergame=Computerspil
Luigi=Luigi
King=Konge
Leach=Igle
LichKing=Lich King
Warcraft=Warcraft
Fireelemental=Fire elemental
Ant=Myre
Termite=Termit
Insects=Insekter
Mosquito=Myg
Mantis=Knæler
Infestation=Infestation
Robot=Robot
Zerg=Zerg
Protoss=Protoss
Terran=Terran
Starcraft=Starcraft
QueenofBlades=Queen of Blades
Zeratul=Zeratul
JimRaynor=Jim Raynor
NeedforSpeed=Need for Speed
ResidentEvil=Resident Evil
TombRaider=Tomb Raider
LaraCroft=Lara Croft
Paint=Maling
Fabergeegg=Faberge æg
Easteregg=Påskeæg
Lighthouse=Fyrtårn
Frog=Frø
Salamander=Salamander
Diet=Diæt
Obesity=Fedme
Rust=Rust
Phoenix=Phoenix
Sniper=Snigskytte
Sushi=Sushi
Vulture=Grib
Weevil=Melbille
Undead=Undead
Vinegar=Eddike
Spinningwheel=Spinderok
Yarn=Garn
Aluminium=Aluminium
Kangaroo=Kænguru
Russia=Rusland
Romania=Rumænien
USA=USA
France=Frankrig
Germany=Tyskland
UK=Storbritannien
China=Kina
Egypt=Egypten
Italy=Italien
SouthAfrica=Sydafrika
Mexico=Mexico
India=Indien
Japan=Japan
Iceland=Island
Switzerland=Schweiz
Australia=Australien
Dracula=Dracula
Somalia=Somalia
SaudiArabia=Saudi Arabien
Napoleon=Napoleon
Antarctica=Antarktis
Brazil=Brasilien
Canada=Canada
Norway=Norge
KarelCapek=Karel Čapek
CzechRepublic=Tjekkiet
Sauna=Sauna
Finland=Finland
Netherlands=Holland
Alcoholic=Alkoholiker
Ashtray=Askebæger
Tropics=Troperne
SugarCane=Sukkerrør
Sugar=Sukker
Caramel=Karamel
Clock=Ur
Firefighter=Brandmand
Firefly=Ildflue
Juice=Juice
LightningRod=Lynafleder
Mirror=Spejl
Peat=Tørv
SwissArmyKnife=Schweizerkniv
ScotchWhiskey=Skotsk whisky
Scotland=Skotland
Samurai=Samurai
Rubber=Gummi
Ball=Bold
Football=Fodbold
StarWars=StarWars
R2D2=R2D2
C3PO=C3P0
Lobster=Hummer
Camel=Kamel
Statue=Statue
Monument=Monument
LibertyStatue=Frihedsgudinden
EiffelTower=Eiffeltårnet
Colosseum=Colosseum
BigBen=Big Ben
TajMahal=Taj Mahal
Playcards=Spillekort
Jellyfish=Gople
Ambulance=Ambulance
Sound=Lyd
Music=Musik
Guitar=Guitar
GuitarHero=Guitar hero
Sport=Sport
F1=Formel 1
Gymnastics=Gymnastik
TableTennis=Bordtennis
AmericanFootball=Amerikansk fodbold
Hockey=Hockey
Rugby=Rugby
Ferrari=Ferrari
Ford=Ford
Mercedes=Mercedes
Audi=Audi
BWM=BMW
Renault=Renault
Nissan=Nissan
Toyota=Toyota
Cricket=Cricket
ManUtd=Manchester United
Chelsea=Chelsea
Arsenal=Arsenal
Liverpool=Liverpool
Picture=Billede
Camera=Kamera
Movie=Film
Theater=Teater
Oscar=Oscar
Linux=Linux
Artist=Kunstner
Hail=Hagl
Airport=Lufthavn
Geek=Nørd
Nerd=Nørd
Blowfish=Kuglefisk
Musician=Musiker
Astronaut=Astronaut
Science=Videnskab
Chemistry=Kemi
Biology=Biologi
Physics=Fysik
Geology=Geologi
Paleontology=Palæontologi
Astronomy=Astronomi
CharlesDarwin=Charles Darwin
MobyDick=Moby Dick
Chalk=Kridt
Blackboard=Tavle
Student=Student
School=Skole
Schoolbus=Skolebus
Soundofmusic=Sound of Music
Money=Penge
Economy=Økonomi
Economics=Økonomi
Dollar=Dollar
Euro=Euro
Pound=Pund
Europe=Europa
Bank=Bank
Vault=Boks
Plastic=Plastik
Creditcard=Kreditkort
Box=Kasse
Container=Container
Cargo=Fragt
Safe=Bankboks
Depositbox=Døgnboks
Toolbox=Værktøjskasse
Basket=Kurv
Basketball=Basketbold
Helmet=Hjelm
Work=Arbejde
Worker=Arbejder
Company=Firma
Factory=Fabrik
Product=Produkt
Christmas=Jul
Gift=Gave
Giftbox=Gavekort
Soundmixer=Sound mixer
Speakers=Højtalere
Language=Sprog
Linguistics=Sprogforskning