Fire=Vuur
Water=Water
Air=Lucht
Earth=Aarde
Ocean=Oceaan
Lava=Lava
Volcano=Vulkaan
Pressure=Druk
Ash=As
Stone=Steen
Metal=Metaal
Wind=Wind
Swamp=Moeras
Energy=Energie
Life=Leven
Algae=Algen
Bacteria=Bacterie
Worm=Worm
Sulfur=Zwavel
Ghost=Geest
Steam=Stoom
Sand=Zand
Dust=Stof
Gunpowder=Buskruit
Mud=Modder
Mite=Mijt
Seed=Zaden
Clay=Klei
Glass=Glas
Snake=Slang
Beach=Strand
Desert=Woestijn
Silicon=Sillicone
Hourglass=Zandloper
Tree=Boom
Egg=Ei
Lizard=Hagedis
Beast=Beest
Monkey=Aap
Man=Man
Grove=Bosjes
Forest=Bos
Tool=Gereedschap
Livestock=Vee
Bear=Beer
Panda=Panda
Shark=Haai
Bird=Vogel
Omelette=Omelet
Turtle=Zeeschildpad
Tortoise=Landschildpad
Fish=Vis
Caviar=Kaviaar
Dinosaur=Dinosauris
Chicken=Kip
Transistor=Transistor
Chip=Chip
Computer=Computer
Radio=Radio
Radar=Radar
Ice=Ijs
PolarBear=Ijsbeer
Hippopotamus=Nijlpaard
Tornado=Tornado
Storm=Storm
Cloud=Wolk
Sky=Hemel
Rain=Regen
Thunderstorm=Onweer
Snow=Sneeuw
Electricity=Electriciteit
Lightbulb=Gloeilamp
Light=Licht
Rainbow=Regenboog
Sun=Zon
Penguin=Pinguïn
Brick=Metselsteen
Beetle=Lieveheersbeestje
Mushroom=Paddestoel
Flower=Bloem
Fruit=Fruit
Watermelon=Watermeloen
Moon=Maan
Planet=Planeet
Solarsystem=Zonnestelsel
Galaxy=Heelal
Universe=Universum
Butterfly=Vlinder
Fly=Vlieg
Dragonfly=Vliegende Draak
Plesiosaur=Plesiosaurus
Pterosaur=Pterosaur
Dragon=Draak
Tiger=Tijger
Star=Ster
Starfish=Zeester
Arm=Wapen
Lightsaber=Lichtzwaard
Firearm=Vuurwapen
Hunter=Jager
Warrior=Strijder
Soldier=Soldaat
Cactus=Cactus
Fisherman=Visser
Poison=Vergif
Lichen=Korstmos
Corpse=Lijk
Fugu=Kogelvis
Assassin=Moordenaar
Sith=Sith
Jedi=Jedi
DarthVader=Darth Vader
Poisonedweapon=Gifwapen
Plankton=Plankton
Whale=Walvis
Shell=Schelp
Limestone=Kalksteen
Pearl=Parel
Snail=Slak
Lime=Kalk
Cement=Cement
Concrete=Beton
Mold=Mold
Cheese=Kaas
Mouse=Muis
Cat=Kat
TomandJerry=Tom en Jerry
Fondue=Fondue
Moss=Mos
Fern=Varen
Fossil=Fossiel
Grass=Gras
Milk=Melk
Manure=Mest
Yogurt=Yoghurt
Flu=Griep
Ozone=Ozon
Airplane=Vliegtuig
Arable=Akker
Geyser=Geiser
Wheat=Tarwe
Flour=Meel
Dough=Deeg
Bread=Brood
Pizza=Pizza
Pie=Taart
Kerogen=Kerogeen
Bitumen=Bitumen
Petroleum=Petroleum
Gasoline=Banzine
Scorpion=Schorpioen
Cochineal=Cochenille
Carmine=Karmijn
Scarab=Kever
TheBeatles=The Beatles
Wheel=Wiel
Bicycle=Fiets
Wagon=Huifkar
Coal=Kolen
Uncutdiamond=Ruwe Diamand
Diamond=Diamand
Boiler=Boiler
Steamengine=Stoommachine
Combustionengine=Verbrandingsmotor
Locomotive=Locomotief
Car=Auto
Motorcycle=Motorfiets
Motorboat=Motorboot
Boat=Boot
Woodenship=Houten Schip
Steamer=Stoomboot
Wood=Hout
Coffin=Doodskist
Pinocchio=Pinokkio
Grape=Druif
Yeast=Gist
Alcohol=Alkohol
Wine=Wijn
Beer=Bier
Tequila=Tequila
Vodka=Wodka
Perfume=Parfum
Paper=Papier
Book=Boek
Library=Bibliotheek
Hut=Hut
House=Huis
Skyscraper=Wolkenkrabber
City=Stad
Country=Land
Continent=Werelddeel
Time=Tijd
Oldman=Oude Man
Christmastree=Kerstboom
Santaclaus=Kerstman
Snowman=Sneeuwpop
Scientist=Wetenschapper
Penicillin=Penicilline
Meat=Vlees
Wool=Wol
Cloth=Weefsel
Clothing=Kleding
Knife=Mes
Scissors=Schaar
Hydrogen=Waterstof
Oxygen=Zuurstof
Carbondioxide=Koolstofdioxide
Sodawater=Spuitwater
CocaCola=Coca Cola
Barbeque=Barbeque
Mummy=Mummie
Pyramid=Pyramide
Anubis=Anoebis
Pharaoh=Pharao
Zombie=Zombie
Frankenstein=Frankenstein
Grave=Graf
Cemetery=Begraafplaats
Blood=Bloed
Sailboat=Zeilboot
Sick=Ziek
Hospital=Ziekenhuis
Museum=Museum
Bar=Bar
Zoo=Dierentuin
Feather=Veer
Pillow=Kussen
Quetzalcoatl=Quetzalcoatl
Bat=Vleermuis
Batman=Batman
Vampire=Vampier
Werewolf=Weerwolf
TwilightSaga=Twilight Saga
Sex=Sex
SexandtheCity=Sex and the City
Kamasutra=Kamasutra
Chariot=Strijdwagen
Berry=Aardbei
Hencoop=Kippenhok
Avianflu=Vogelgriep
Pig=Varken
Swineflu=Varkensgriep
Bacon=Bacon
Soap=Zeep
Jungle=Jungle
JungleBook=Jungle Book
Hero=Held
RobinHood=Robin Hood
Submarine=Onderzeeër
CaptainNemo=Kapitein Nemo
Island=Eiland
Fat=Vet
Pilot=Piloot
Captain=Kapitein
Pirate=Piraat
Pirateship=Piratenschip
Treasure=Schat
Love=Liefde
Sandwich=Sandwich
McDonalds=McDonalds
Bow=Boog
Dam=Dam
Beaver=Bever
Champagne=Champagne
Ceramics=Keramiek
Ectoplasm=Ectoplasma
Reed=Riet
Tobacco=Tabak
Cigarettes=Sigaretten
Cancer=Kanker
Smoke=Rook
Alchemist=Alchemist
Gold=Goud
Radioactivity=Radioactiviteit
Uranium=Uranium
Plutonium=Plutonium
Atomicbomb=Atoombom
Hydrogenbomb=Waterstofbom
Alien=Buitenaards Wezen
Starship=Sterrenschip
CaptainPicard=Kapitein Picard
USSEnterprise=USS Enterprise
Supernova=Superster
Blackhole=Zwart Gat
Wormhole=Wormgat
Void=Luchtledige
BigBang=Oerknal
BigCrunch=Implosie
Idea=Idee
StephenHawking=Stephen Hawking
AlbertEinstein=Albert Einstein
Relativitytheory=Relativiteitstheorie
Lamp=Lamp
Lavalamp=Lava lamp
Genie=Genie
Prisoner=Gevangene
Coral=Koraal
VWBeetle=VW Kever
Toast=Toast
Explosion=Explosie
OneUP=Extra Leven
Mario=Mario
Yoshi=Yoshi
Yoshiegg=Yoshi ei
Team=Team
Boomushroom=Boo mushroom
Computergame=Computerspel
Luigi=Luigi
King=Koning
Leach=Bloedzuiger
LichKing=Lich King
Warcraft=Warcraft
Fireelemental=Vuurfiguur
Ant=Mier
Termite=Termiet
Insects=Insecten
Mosquito=Mug
Mantis=Sprinkhaan
Infestation=Plaag
Robot=Robot
Zerg=Zerg
Protoss=Protoss
Terran=Terran
Starcraft=Starcraft
QueenofBlades=Queen of Blades
Zeratul=Zeratul
JimRaynor=Jim Raynor
NeedforSpeed=Need for Speed
ResidentEvil=Resident Evil
TombRaider=Tomb Raider
LaraCroft=Lara Croft
Paint=Verf
Fabergeegg=Fabergé Eieren
Easteregg=Paasei
Lighthouse=Vuurtoren
Frog=Kikker
Salamander=Salamander
Diet=Dieet
Obesity=Overgewicht
Rust=Roest
Phoenix=Feniks
Sniper=Sluipschutter
Sushi=Sushi
Vulture=Gier
Weevil=Langsnuitkever
Undead=Ondodo
Vinegar=Azijn
Spinningwheel=Spinnewiel
Yarn=Garen
Aluminium=Aluminium
Kangaroo=Kangaroo
Russia=Rusland
Romania=Roemenië
USA=USA
France=Frankrijk
Germany=Duitsland
UK=Engeland
China=China
Egypt=Egypte
Italy=Italië
SouthAfrica=Zuid Afrika
Mexico=Mexico
India=India
Japan=Japan
Iceland=Ijsland
Switzerland=Zwitserland
Australia=Australië
Dracula=Dracula
Somalia=Somalië
SaudiArabia=Saudi Arabia
Napoleon=Napoleon
Antarctica=Antarctica
Brazil=Brazilië
Canada=Canada
Norway=Noorwegen
KarelCapek=Karel Čapek
CzechRepublic=Tsjechische republiek
Sauna=Sauna
Finland=Finland
Netherlands=Nederland
Alcoholic=Alcoholist
Ashtray=Asbak
Tropics=Tropen
SugarCane=Suikerriet
Sugar=Suiker
Caramel=Caramel
Clock=Klok
Firefighter=Brandweerman
Firefly=Vuurvlieg
Juice=Vruchtensap
LightningRod=Bliksemafleider
Mirror=Spiegel
Peat=Turf
SwissArmyKnife=Zwitsers zakmes
ScotchWhiskey=Schotse Whiskey
Scotland=Schotland
Samurai=Samoerai
Rubber=Rubber
Ball=Bal
Football=Voetbal
StarWars=StarWars
R2D2=R2D2
C3PO=C3P0
Lobster=Kreeft
Camel=Kameel
Statue=Standbeeld
Monument=Monument
LibertyStatue=Vrijheidsbeeld
EiffelTower=Eiffeltoren
Colosseum=Colosseum
BigBen=Big Ben
TajMahal=Taj Mahal
Playcards=Speelkaarten
Jellyfish=Kwal
Ambulance=Ambulance
Sound=Geluid
Music=Muziek
Guitar=Gitaar
GuitarHero=Guitar hero
Sport=Sport
F1=Formule 1
Gymnastics=Gymnastiek
TableTennis=Tafeltennis
AmericanFootball=American football
Hockey=Hockey
Rugby=Rugby
Ferrari=Ferrari
Ford=Ford
Mercedes=Mercedes
Audi=Audi
BWM=BMW
Renault=Renault
Nissan=Nissan
Toyota=Toyota
Cricket=Cricket
ManUtd=Manchester United
Chelsea=Chelsea
Arsenal=Arsenal
Liverpool=Liverpool
Picture=Foto
Camera=Camera
Movie=Film
Theater=Theater
Oscar=Oscar
Linux=Linux
Artist=Kunstenaar
Hail=Hagel
Airport=Luchthaven
Geek=Geek
Nerd=Nerd
Blowfish=Blowfish
Musician=Muzikant
Astronaut=Astronaut
Science=Wetenschap
Chemistry=Chemie
Biology=Biologie
Physics=Fysica
Geology=Geologie
Paleontology=Paleontologie
Astronomy=Astronomie
CharlesDarwin=Charles Darwin
MobyDick=Moby Dick
Chalk=Krijt
Blackboard=Schoolbord
Student=Student
School=School
Schoolbus=Schoolbus
Soundofmusic=Sound of Music
Money=Geld
Economy=Economie
Economics=Economics
Dollar=Dollar
Euro=Euro
Pound=Pond
Europe=Europa
Bank=Bank
Vault=Vault
Plastic=Plastic
Creditcard=Creditcard
Box=Doos
Container=Container
Cargo=Lading
Safe=Veilig
Depositbox=Kluis
Toolbox=Gereedschapskist
Basket=Mand
Basketball=Basketbal
Helmet=Helm
Work=Werk
Worker=Werker
Company=Vennootschap
Factory=Fabriek
Product=Product
Christmas=Kerstmis
Gift=Gift
Giftbox=Geschenkdoos
Soundmixer=Sound mixer
Speakers=Luidsprekers
Language=Taal
Linguistics=Taalwetenschap