Fire=Fire
Water=Water
Air=Air
Earth=Earth
Ocean=Ocean
Lava=Lava
Volcano=Volcano
Pressure=Pressure
Ash=Ash
Stone=Stone
Metal=Metal
Wind=Wind
Swamp=Swamp
Energy=Energy
Life=Life
Algae=Algae
Bacteria=Bacteria
Worm=Worm
Sulfur=Sulfur
Ghost=Ghost
Steam=Steam
Sand=Sand
Dust=Dust
Gunpowder=Gunpowder
Mud=Mud
Mite=Mite
Seed=Seed
Clay=Clay
Glass=Glass
Snake=Snake
Beach=Beach
Desert=Desert
Silicon=Silicon
Hourglass=Hourglass
Tree=Tree
Egg=Egg
Lizard=Lizard
Beast=Beast
Monkey=Monkey
Man=Man
Grove=Grove
Forest=Forest
Tool=Tool
Livestock=Livestock
Bear=Bear
Panda=Panda
Shark=Shark
Bird=Bird
Omelette=Omelette
Turtle=Turtle
Tortoise=Tortoise
Fish=Fish
Caviar=Caviar
Dinosaur=Dinosaur
Chicken=Chicken
Transistor=Transistor
Chip=Chip
Computer=Computer
Radio=Radio
Radar=Radar
Ice=Ice
PolarBear=Polar Bear
Hippopotamus=Hippopotamus
Tornado=Tornado
Storm=Storm
Cloud=Cloud
Sky=Sky
Rain=Rain
Thunderstorm=Thunderstorm
Snow=Snow
Electricity=Electricity
Lightbulb=Lightbulb
Light=Light
Rainbow=Rainbow
Sun=Sun
Penguin=Penguin
Brick=Brick
Beetle=Beetle
Mushroom=Mushroom
Flower=Flower
Fruit=Fruit
Watermelon=Watermelon
Moon=Moon
Planet=Planet
Solarsystem=Solar system
Galaxy=Galaxy
Universe=Universe
Butterfly=Butterfly
Fly=Fly
Dragonfly=Dragonfly
Plesiosaur=Plesiosaur
Pterosaur=Pterosaur
Dragon=Dragon
Tiger=Tiger
Star=Star
Starfish=Starfish
Arm=Arm
Lightsaber=Lightsaber
Firearm=Firearm
Hunter=Hunter
Warrior=Warrior
Soldier=Soldier
Cactus=Cactus
Fisherman=Fisherman
Poison=Poison
Lichen=Lichen
Corpse=Corpse
Fugu=Fugu
Assassin=Assassin
Sith=Sith
Jedi=Jedi
DarthVader=Darth Vader
Poisonedweapon=Poisoned weapon
Plankton=Plankton
Whale=Whale
Shell=Shell
Limestone=Limestone
Pearl=Pearl
Snail=Snail
Lime=Lime
Cement=Cement
Concrete=Concrete
Mold=Mold
Cheese=Cheese
Mouse=Mouse
Cat=Cat
TomandJerry=Tom and Jerry
Fondue=Fondue
Moss=Moss
Fern=Fern
Fossil=Fossil
Grass=Grass
Milk=Milk
Manure=Manure
Yogurt=Yogurt
Flu=Flu
Ozone=Ozone
Airplane=Airplane
Arable=Arable
Geyser=Geyser
Wheat=Wheat
Flour=Flour
Dough=Dough
Bread=Bread
Pizza=Pizza
Pie=Pie
Kerogen=Kerogen
Bitumen=Bitumen
Petroleum=Petroleum
Gasoline=Gasoline
Scorpion=Scorpion
Cochineal=Cochineal
Carmine=Carmine
Scarab=Scarab
TheBeatles=The Beatles
Wheel=Wheel
Bicycle=Bicycle
Wagon=Wagon
Coal=Coal
Uncutdiamond=Uncut diamond
Diamond=Diamond
Boiler=Boiler
Steamengine=Steam engine
Combustionengine=Combustion engine
Locomotive=Locomotive
Car=Car
Motorcycle=Motorcycle
Motorboat=Motorboat
Boat=Boat
Woodenship=Wooden ship
Steamer=Steamer
Wood=Wood
Coffin=Coffin
Pinocchio=Pinocchio
Grape=Grape
Yeast=Yeast
Alcohol=Alcohol
Wine=Wine
Beer=Beer
Tequila=Tequila
Vodka=Vodka
Perfume=Perfume
Paper=Paper
Book=Book
Library=Library
Hut=Hut
House=House
Skyscraper=Skyscraper
City=City
Country=Country
Continent=Continent
Time=Time
Oldman=Old man
Christmastree=Christmas tree
Santaclaus=Santa claus
Snowman=Snowman
Scientist=Scientist
Penicillin=Penicillin
Meat=Meat
Wool=Wool
Cloth=Cloth
Clothing=Clothing
Knife=Knife
Scissors=Scissors
Hydrogen=Hydrogen
Oxygen=Oxygen
Carbondioxide=Carbon dioxide
Sodawater=Soda water
CocaCola=Coca Cola
Barbeque=Barbeque
Mummy=Mummy
Pyramid=Pyramid
Anubis=Anubis
Pharaoh=Pharaoh
Zombie=Zombie
Frankenstein=Frankenstein
Grave=Grave
Cemetery=Cemetery
Blood=Blood
Sailboat=Sailboat
Sick=Sick
Hospital=Hospital
Museum=Museum
Bar=Bar
Zoo=Zoo
Feather=Feather
Pillow=Pillow
Quetzalcoatl=Quetzalcoatl
Bat=Bat
Batman=Batman
Vampire=Vampire
Werewolf=Werewolf
TwilightSaga=Twilight Saga
Sex=Sex
SexandtheCity=Sex and the City
Kamasutra=Kamasutra
Chariot=Chariot
Berry=Berry
Hencoop=Hen coop
Avianflu=Avian flu
Pig=Pig
Swineflu=Swine flu
Bacon=Bacon
Soap=Soap
Jungle=Jungle
JungleBook=Jungle Book
Hero=Hero
RobinHood=Robin Hood
Submarine=Submarine
CaptainNemo=Captain Nemo
Island=Island
Fat=Fat
Pilot=Pilot
Captain=Captain
Pirate=Pirate
Pirateship=Pirate ship
Treasure=Treasure
Love=Love
Sandwich=Sandwich
McDonalds=McDonalds
Bow=Bow
Dam=Dam
Beaver=Beaver
Champagne=Champagne
Ceramics=Ceramics
Ectoplasm=Ectoplasm
Reed=Reed
Tobacco=Tobacco
Cigarettes=Cigarettes
Cancer=Cancer
Smoke=Smoke
Alchemist=Alchemist
Gold=Gold
Radioactivity=Radioactivity
Uranium=Uranium
Plutonium=Plutonium
Atomicbomb=Atomic bomb
Hydrogenbomb=Hydrogen bomb
Alien=Alien
Starship=Starship
CaptainPicard=Captain Picard
USSEnterprise=USS Enterprise
Supernova=Supernova
Blackhole=Black hole
Wormhole=Wormhole
Void=Void
BigBang=Big Bang
BigCrunch=Big Crunch
Idea=Idea
StephenHawking=Stephen Hawking
AlbertEinstein=Albert Einstein
Relativitytheory=Relativity theory
Lamp=Lamp
Lavalamp=Lava lamp
Genie=Genie
Prisoner=Prisoner
Coral=Coral
VWBeetle=VW Beetle
Toast=Toast
Explosion=Explosion
OneUP=1UP
Mario=Mario
Yoshi=Yoshi
Yoshiegg=Yoshi egg
Team=Team
Boomushroom=Boo mushroom
Computergame=Computer game
Luigi=Luigi
King=King
Leach=Leech
LichKing=Lich King
Warcraft=Warcraft
Fireelemental=Fire elemental
Ant=Ant
Termite=Termite
Insects=Insects
Mosquito=Mosquito
Mantis=Mantis
Infestation=Infestation
Robot=Robot
Zerg=Zerg
Protoss=Protoss
Terran=Terran
Starcraft=Starcraft
QueenofBlades=Queen of Blades
Zeratul=Zeratul
JimRaynor=Jim Raynor
NeedforSpeed=Need for Speed
ResidentEvil=Resident Evil
TombRaider=Tomb Raider
LaraCroft=Lara Croft
Paint=Paint
Fabergeegg=Faberge egg
Easteregg=Easter egg
Lighthouse=Lighthouse
Frog=Frog
Salamander=Salamander
Diet=Diet
Obesity=Obesity
Rust=Rust
Phoenix=Phoenix
Sniper=Sniper
Sushi=Sushi
Vulture=Vulture
Weevil=Weevil
Undead=Undead
Vinegar=Vinegar
Spinningwheel=Spinning wheel
Yarn=Yarn
Aluminium=Aluminium
Kangaroo=Kangaroo
Russia=Russia
Romania=Romania
USA=USA
France=France
Germany=Germany
UK=UK
China=China
Egypt=Egypt
Italy=Italy
SouthAfrica=South Africa
Mexico=Mexico
India=India
Japan=Japan
Iceland=Iceland
Switzerland=Switzerland
Australia=Australia
Dracula=Dracula
Somalia=Somalia
SaudiArabia=Saudi Arabia
Napoleon=Napoleon
Antarctica=Antarctica
Brazil=Brazil
Canada=Canada
Norway=Norway
KarelCapek=Karel Čapek
CzechRepublic=Czech Republic
Sauna=Sauna
Finland=Finland
Netherlands=Netherlands
Alcoholic=Alcoholic
Ashtray=Ashtray
Tropics=Tropics
SugarCane=Sugar cane
Sugar=Sugar
Caramel=Caramel
Clock=Clock
Firefighter=Firefighter
Firefly=Firefly
Juice=Juice
LightningRod=Lightning rod
Mirror=Mirror
Peat=Peat
SwissArmyKnife=Swiss knife
ScotchWhiskey=Scotch whiskey
Scotland=Scotland
Samurai=Samurai
Rubber=Rubber
Ball=Ball
Football=Football
StarWars=StarWars
R2D2=R2D2
C3PO=C3P0
Lobster=Lobster
Camel=Camel
Statue=Statue
Monument=Monument
LibertyStatue=Liberty Statue
EiffelTower=Eiffel Tower
Colosseum=Colosseum
BigBen=Big Ben
TajMahal=Taj Mahal
Playcards=Playcards
Jellyfish=Jellyfish
Ambulance=Ambulance
Sound=Sound
Music=Music
Guitar=Guitar
GuitarHero=Guitar hero
Sport=Sport
F1=Formula 1
Gymnastics=Gymnastics
TableTennis=Table tennis
AmericanFootball=American football
Hockey=Hockey
Rugby=Rugby
Ferrari=Ferrari
Ford=Ford
Mercedes=Mercedes
Audi=Audi
BWM=BMW
Renault=Renault
Nissan=Nissan
Toyota=Toyota
Cricket=Cricket
ManUtd=Manchester United
Chelsea=Chelsea
Arsenal=Arsenal
Liverpool=Liverpool
Picture=Picture
Camera=Camera
Movie=Movie
Theater=Theater
Oscar=Oscar
Linux=Linux
Artist=Artist
Hail=Hail
Airport=Airport
Geek=Geek
Nerd=Nerd
Blowfish=Blowfish
Musician=Musician
Astronaut=Astronaut
Science=Science
Chemistry=Chemistry
Biology=Biology
Physics=Physics
Geology=Geology
Paleontology=Paleontology
Astronomy=Astronomy
CharlesDarwin=Charles Darwin
MobyDick=Moby Dick
Chalk=Chalk
Blackboard=Blackboard
Student=Student
School=School
Schoolbus=School bus
Soundofmusic=Sound of Music
Money=Money
Economy=Economy
Economics=Economics
Dollar=Dollar
Euro=Euro
Pound=Pound
Europe=Europe
Bank=Bank
Vault=Vault
Plastic=Plastic
Creditcard=Creditcard
Box=Box
Container=Container
Cargo=Cargo
Safe=Safe
Depositbox=Deposit box
Toolbox=Toolbox
Basket=Basket
Basketball=Basketball
Helmet=Helmet
Work=Work
Worker=Worker
Company=Company
Factory=Factory
Product=Product
Christmas=Christmas
Gift=Gift
Giftbox=Giftbox
Soundmixer=Sound mixer
Speakers=Speakers
Language=Language
Linguistics=Linguistics