Fire=Feu
Water=Eau
Air=Air
Earth=Terre
Ocean=Océan
Lava=Lave
Volcano=Volcan
Pressure=Pression
Ash=Cendre
Stone=Pierre
Metal=Métal
Wind=vent
Swamp=Marais
Energy=Energie
Life=Vie
Algae=Algue
Bacteria=Bactérie
Worm=Ver
Sulfur=Soufre
Ghost=Fantome
Steam=Vapeur
Sand=Sable
Dust=Poussière
Gunpowder=Poudre
Mud=Boue
Mite=Mite
Seed=Graine
Clay=Argile
Glass=Verre
Snake=Serpent
Beach=Plage
Desert=Désert
Silicon=Silicium
Hourglass=Sablier
Tree=Arbre
Egg=Oeuf
Lizard=Lézard
Beast=Bête
Monkey=Singe
Man=Homme
Grove=Bosquet
Forest=Forêt
Tool=Outils
Livestock=bétail
Bear=Ours
Panda=Panda
Shark=Requin
Bird=Oiseau
Omelette=Omelette
Turtle=Tortue marine
Tortoise=Tortue
Fish=Poisson
Caviar=Caviar
Dinosaur=Dinosaure
Chicken=Poulet
Transistor=Transistor
Chip=Puce
Computer=Ordinateur
Radio=Radio
Radar=Radar
Ice=Glace
PolarBear=Ours polaire
Hippopotamus=Hippopotame
Tornado=Tornade
Storm=Tempête
Cloud=Nuage
Sky=Ciel
Rain=Pluie
Thunderstorm=Orage
Snow=Neige
Electricity=Electricité
Lightbulb=Ampoule
Light=Lumière
Rainbow=Arc-en-ciel
Sun=Soleil
Penguin=Penguin
Brick=Briques
Beetle=Coccinelle
Mushroom=Champignon
Flower=Fleur
Fruit=Fruit
Watermelon=Melon d'eau
Moon=Lune
Planet=Planète
Solarsystem=Système solaire
Galaxy=Galaxie
Universe=Univers
Butterfly=Papillon
Fly=Mouche
Dragonfly=Libellule
Plesiosaur=Plesiosaure
Pterosaur=Pterosaure
Dragon=Dragon
Tiger=Tigre
Star=Etoile
Starfish=Etoile de mer
Arm=Arme
Lightsaber=Sabre laser
Firearm=Arme à feu
Hunter=Chasseur
Warrior=Guerrier
Soldier=Soldat
Cactus=Cactus
Fisherman=Pêcheur
Poison=Poison
Lichen=Lichen
Corpse=Cadavre
Fugu=Fugu
Assassin=Assassin
Sith=Sith
Jedi=Jedi
DarthVader=Dark Vador
Poisonedweapon=Arme toxique
Plankton=Plancton
Whale=Baleine
Shell=Coquillage
Limestone=Calcaire
Pearl=Pèrle
Snail=Escargot
Lime=Chaux
Cement=Ciment
Concrete=Béton
Mold=Moisissure
Cheese=Fromage
Mouse=Souris
Cat=Chat
TomandJerry=Tom et Jerry
Fondue=Fondue
Moss=Mousse
Fern=Fougère
Fossil=Fossile
Grass=Herbe
Milk=Lait
Manure=Escrément
Yogurt=Yaourt
Flu=Grippe
Ozone=Ozone
Airplane=Avion
Arable=Cultures
Geyser=Geyser
Wheat=Récoltes
Flour=Farine
Dough=Pâte
Bread=Pain
Pizza=Pizza
Pie=Tarte
Kerogen=Kerogène
Bitumen=Bitume
Petroleum=Petrole
Gasoline=Essence
Scorpion=Scorpion
Cochineal=Cochenille
Carmine=Carmin
Scarab=Scarabée
TheBeatles=Les Beatles
Wheel=Roue
Bicycle=Bicyclette
Wagon=Wagon
Coal=Charbon
Uncutdiamond=Diamant brut
Diamond=Diamant
Boiler=Chaudière
Steamengine=Machine à vapeur
Combustionengine=Machine à combustion
Locomotive=Locomotive
Car=Voiture
Motorcycle=Moto
Motorboat=Bateau à moteur
Boat=Bateau
Woodenship=Bateau en bois
Steamer=Bateau à vapeur
Wood=Bois
Coffin=Cercueil
Pinocchio=Pinocchio
Grape=Raisin
Yeast=Pelote
Alcohol=Alcool
Wine=Vin
Beer=Bière
Tequila=Tequila
Vodka=Vodka
Perfume=Parfum
Paper=Papier
Book=Livre
Library=Librarie
Hut=Cabane
House=Maison
Skyscraper=Gratte-ciel
City=Ville
Country=Pays
Continent=Continent
Time=Temps
Oldman=Vieil homme
Christmastree=Sapin de Noël
Santaclaus=Père Noël
Snowman=Bonhomme de neige
Scientist=Scientifique
Penicillin=Penicilline
Meat=Viande
Wool=Laine
Cloth=Tissu
Clothing=Vêtement
Knife=Couteau
Scissors=Ciseaux
Hydrogen=Hydrogène
Oxygen=Oxygène
Carbondioxide=Dioxide de carbon
Sodawater=Soda
CocaCola=Coca Cola
Barbeque=Barbecue
Mummy=Momie
Pyramid=Pyramide
Anubis=Anubis
Pharaoh=Pharaon
Zombie=Zombie
Frankenstein=Frankenstein
Grave=Tombe
Cemetery=Cimetière
Blood=Sang
Sailboat=Voilier
Sick=Malade
Hospital=Hopital
Museum=Musée
Bar=Bar
Zoo=Zoo
Feather=Plume
Pillow=Oreiller
Quetzalcoatl=Quetzalcoatl
Bat=Chauve souris
Batman=Batman
Vampire=Vampire
Werewolf=Loup Garou
TwilightSaga=Série Twilight
Sex=Sexe
SexandtheCity=Sex and the City
Kamasutra=Kamasutra
Chariot=Char
Berry=Fruit Rouge
Hencoop=Poulailler
Avianflu=Grippe Aviaire
Pig=Cochon
Swineflu=Grippe porcine
Bacon=Bacon
Soap=Savon
Jungle=Jungle
JungleBook=Livre de la Jungle
Hero=Héros
RobinHood=Robin des bois
Submarine=Sous marin
CaptainNemo=Capitaine Nemo
Island=Ile
Fat=Graisse
Pilot=Pilote
Captain=Capitaine
Pirate=Pirate
Pirateship=Bateau pirate
Treasure=Trésor
Love=Amour
Sandwich=Sandwich
McDonalds=McDonalds
Bow=Arc
Dam=Barrage
Beaver=Castor
Champagne=Champagne
Ceramics=Ceramiques
Ectoplasm=Ectoplasme
Reed=Roseau
Tobacco=Tabac
Cigarettes=Cigarettes
Cancer=Cancer
Smoke=Fumée
Alchemist=Alchimiste
Gold=Or
Radioactivity=Radioactivité
Uranium=Uranium
Plutonium=Plutonium
Atomicbomb=Bombe atomique
Hydrogenbomb=Bombe H.
Alien=Alien
Starship=Vaisseau
CaptainPicard=Capitaine Picard
USSEnterprise=USS Enterprise
Supernova=Supernova
Blackhole=Trou noir 
Wormhole=Trou de ver
Void=Vide
BigBang=Big Bang
BigCrunch=Big Crunch
Idea=Idée
StephenHawking=Stephen Hawking
AlbertEinstein=Albert Einstein
Relativitytheory=Théorie de la relativité
Lamp=Lampe
Lavalamp=Lampe à lave
Genie=Génie
Prisoner=Prisonnier
Coral=Corail
VWBeetle=VW Coccinelle
Toast=Toast
Explosion=Explosion
OneUP=1UP
Mario=Mario
Yoshi=Yoshi
Yoshiegg=Oeuf de Yoshi
Team=Equipe
Boomushroom=Champignon Boo
Computergame=Jeu video
Luigi=Luigi
King=Roi
Leach=Sangsue
LichKing=Roi Liche
Warcraft=Warcraft
Fireelemental=Elémentaire de Feu
Ant=Fourmis
Termite=Termite
Insects=Insecte
Mosquito=Moustique
Mantis=Mante religieuse
Infestation=Invasion
Robot=Robot
Zerg=Zerg
Protoss=Protoss
Terran=Terran
Starcraft=Starcraft
QueenofBlades=Queen of Blades
Zeratul=Zeratul
JimRaynor=Jim Raynor
NeedforSpeed=Need for Speed
ResidentEvil=Resident Evil
TombRaider=Tomb Raider
LaraCroft=Lara Croft
Paint=Peinture
Fabergeegg=Œuf de Fabergé
Easteregg=Œuf de Pâques
Lighthouse=Phare
Frog=Grenouille
Salamander=Salamandre
Diet=Régime
Obesity=Obesité
Rust=Rouille
Phoenix=Phénix
Sniper=Sniper
Sushi=Sushi
Vulture=Vautour
Weevil=Weevil
Undead=Mort vivant
Vinegar=Vinaigre
Spinningwheel=Rouet
Yarn=Levure
Aluminium=Aluminium
Kangaroo=Kangourou
Russia=Russie
Romania=Roumanie
USA=USA
France=France
Germany=Allemagne
UK=Grande Bretagne
China=Chine
Egypt=Egypte
Italy=Italie
SouthAfrica=Afrique du Sud
Mexico=Mexique
India=Inde
Japan=Japon
Iceland=Islande
Switzerland=Suisse
Australia=Australie
Dracula=Dracula
Somalia=Somalie
SaudiArabia=Arabie Saoudite
Napoleon=Napoléon
Antarctica=Antarctique
Brazil=Brésil
Canada=Canada
Norway=Norvège
KarelCapek=Karel Čapek
CzechRepublic=Rep. Tchèque
Sauna=Sauna
Finland=Finlande
Netherlands=Pays bas
Alcoholic=Alcoolique
Ashtray=Cendrier
Tropics=Tropiques
SugarCane=Canne à sucre
Sugar=Sucre
Caramel=Caramel
Clock=Horloge
Firefighter=Pompier
Firefly=Luciole
Juice=Jus
LightningRod=Paratonnerre
Mirror=Miroir
Peat=Tourbe
SwissArmyKnife=Couteau Suisse
ScotchWhiskey=Whisky
Scotland=Ecosse
Samurai=Samuraï
Rubber=Gomme
Ball=Balle
Football=Football
StarWars=StarWars
R2D2=R2D2
C3PO=C3P0
Lobster=homar
Camel=Chameau
Statue=Statue
Monument=Monument
LibertyStatue=Statue de la liberté
EiffelTower=Tour Eiffel
Colosseum=Colosse
BigBen=Big Ben
TajMahal=Taj Mahal
Playcards=Cartes à jouer
Jellyfish=Méduse
Ambulance=Ambulance
Sound=Son
Music=Music
Guitar=Guitare
GuitarHero=Guitar hero
Sport=Sport
F1=Formule 1
Gymnastics=Gymnastique
TableTennis=Tennis de table
AmericanFootball=Football americain
Hockey=Hockey
Rugby=Rugby
Ferrari=Ferrari
Ford=Ford
Mercedes=Mercedes
Audi=Audi
BWM=BMW
Renault=Renault
Nissan=Nissan
Toyota=Toyota
Cricket=Cricket
ManUtd=Manchester United
Chelsea=Chelsea
Arsenal=Arsenal
Liverpool=Liverpool
Picture=photos
Camera=Appareil photo
Movie=Film
Theater=Théâtre
Oscar=Oscar
Linux=Linux
Artist=Artist
Hail=Hail
Airport=Airport
Geek=Geek
Nerd=Nerd
Blowfish=Blowfish
Musician=Musician
Astronaut=Astronaut
Science=Science
Chemistry=Chemistry
Biology=Biology
Physics=Physics
Geology=Geology
Paleontology=Paleontology
Astronomy=Astronomy
CharlesDarwin=Charles Darwin
MobyDick=Moby Dick
Chalk=Chalk
Blackboard=Blackboard
Student=Student
School=School
Schoolbus=Schoolbus
Soundofmusic=Sound of Music
Money=Money
Economy=Economy
Economics=Economics
Dollar=Dollar
Euro=Euro
Pound=Pound
Europe=Europe
Bank=Bank
Vault=Vault
Plastic=Plastic
Creditcard=Creditcard
Box=Box
Container=Container
Cargo=Cargo
Safe=Safe
Depositbox=Deposit box
Toolbox=Toolbox
Basket=Basket
Basketball=Basketball
Helmet=Helmet
Work=Work
Worker=Worker
Company=Company
Factory=Factory
Product=Product
Christmas=Christmas
Gift=Gift
Giftbox=Giftbox
Soundmixer=Sound mixer
Speakers=Speakers
Language=Language
Linguistics=Linguistics