Fire=Feuer
Water=Wasser
Air=Luft
Earth=Erde
Ocean=Ozean
Lava=Lava
Volcano=Vulkan
Pressure=Druck
Ash=Asche
Stone=Stein
Metal=Metall
Wind=Wind
Swamp=Sumpf
Energy=Energie
Life=Leben
Algae=Algen
Bacteria=Bakterien
Worm=Wurm
Sulfur=Schwefel
Ghost=Geist
Steam=Dampf
Sand=Sand
Dust=Staub
Gunpowder=Schießpulver
Mud=Schlamm
Mite=Milbe
Seed=Samen
Clay=Lehm
Glass=Glas
Snake=Schlange
Beach=Strand
Desert=Wüste
Silicon=Silizium
Hourglass=Sanduhr
Tree=Baum
Egg=Ei
Lizard=Echse
Beast=Tier
Monkey=Affe
Man=Mensch
Grove=Gehölz
Forest=Wald
Tool=Werkzeug
Livestock=Vieh
Bear=Bär
Panda=Panda
Shark=Hai
Bird=Vogel
Omelette=Omelett
Turtle=Wasserschildkröte
Tortoise=Landschildkröte
Fish=Fisch
Caviar=Kaviar
Dinosaur=Dinosaurier
Chicken=Huhn
Transistor=Transistor
Chip=Chip
Computer=Computer
Radio=Radio
Radar=Radar
Ice=Eis
PolarBear=Eisbär
Hippopotamus=Nilpferd
Tornado=Tornado
Storm=Sturm
Cloud=Wolke
Sky=Himmel
Rain=Regen
Thunderstorm=Gewitter
Snow=Schnee
Electricity=Elektrizität
Lightbulb=Glühbirne
Light=Licht
Rainbow=Regenbogen
Sun=Sonne
Penguin=Pinguin
Brick=Ziegelstein
Beetle=Käfer
Mushroom=Pilz
Flower=Blume
Fruit=Frucht
Watermelon=Wassermelone
Moon=Mond
Planet=Planet
Solarsystem=Sonnensystem
Galaxy=Galaxie
Universe=Universum
Butterfly=Schmetterling
Fly=Fliege
Dragonfly=Libelle
Plesiosaur=Plesiosaurier
Pterosaur=Pterosaurus
Dragon=Drache
Tiger=Tiger
Star=Stern
Starfish=Seestern
Arm=Waffe
Lightsaber=Lichtschwert
Firearm=Schusswaffe
Hunter=Jäger
Warrior=Krieger
Soldier=Soldat
Cactus=Kaktus
Fisherman=Fischer
Poison=Gift
Lichen=Flechte
Corpse=Leiche
Fugu=Fugu
Assassin=Attentäter
Sith=Sith
Jedi=Jedi
DarthVader=Darth Vader
Poisonedweapon=chemische Waffe
Plankton=Plankton
Whale=Wal
Shell=Muschel
Limestone=Kalkstein
Pearl=Perle
Snail=Schnecke
Lime=Kalk
Cement=Zement
Concrete=Beton
Mold=Schimmel
Cheese=Käse
Mouse=Maus
Cat=Katze
TomandJerry=Tom und Jerry
Fondue=Fondue
Moss=Moos
Fern=Farn
Fossil=Fossilien
Grass=Gras
Milk=Milch
Manure=Dünger
Yogurt=Joghurt
Flu=Grippe
Ozone=Ozon
Airplane=Flugzeug
Arable=Acker
Geyser=Geysir
Wheat=Weizen
Flour=Mehl
Dough=Teig
Bread=Brot
Pizza=Pizza
Pie=Torte
Kerogen=Kerogen
Bitumen=Teer
Petroleum=Erdöl
Gasoline=Benzin
Scorpion=Skorpion
Cochineal=Cochenille
Carmine=Karmin
Scarab=Blatthornkäfer
TheBeatles=The Beatles
Wheel=Rad
Bicycle=Fahrrad
Wagon=Wagen
Coal=Kohle
Uncutdiamond=ungeschliffener Diamant
Diamond=Diamant
Boiler=Kessel
Steamengine=Dampfmaschine
Combustionengine=Verbrennungsmotor
Locomotive=Lokomotive
Car=Auto
Motorcycle=Motorrad
Motorboat=Motorboot
Boat=Boot
Woodenship=Holzschiff
Steamer=Dampfer
Wood=Holz
Coffin=Sarg
Pinocchio=Pinocchio
Grape=Weintraube
Yeast=Hefe
Alcohol=Alkohol
Wine=Wein
Beer=Bier
Tequila=Tequila
Vodka=Wodka
Perfume=Perfüm
Paper=Papier
Book=Buch
Library=Bibliothek
Hut=Hütte
House=Haus
Skyscraper=Wolkenkratzer
City=Stadt
Country=Land
Continent=Kontinent
Time=Zeit
Oldman=Greis
Christmastree=Weihnachtsbaum
Santaclaus=Weihnachtsmann
Snowman=Schneemann
Scientist=Wissenschaftler
Penicillin=Penizillin
Meat=Fleisch
Wool=Wolle
Cloth=Stoff
Clothing=Kleidung
Knife=Messer
Scissors=Schere
Hydrogen=Wasserstoff
Oxygen=Sauerstoff
Carbondioxide=Kohlendioxid
Sodawater=Tafelwasser
CocaCola=Coca Cola
Barbeque=Grill
Mummy=Mumie
Pyramid=Pyramide
Anubis=Anubis
Pharaoh=Pharaoh
Zombie=Zombie
Frankenstein=Frankenstein
Grave=Grab
Cemetery=Friedhof
Blood=Blut
Sailboat=Segelboot
Sick=Krankheit
Hospital=Krankenhaus
Museum=Museum
Bar=Bar
Zoo=Zoo
Feather=Feder
Pillow=Kissen
Quetzalcoatl=gefiederte Schlange
Bat=Fledermaus
Batman=Batman
Vampire=Vampir
Werewolf=Werwolf
TwilightSaga=Twilight Saga
Sex=Sex
SexandtheCity=Sex and the City
Kamasutra=Kamasutra
Chariot=Streitwagen
Berry=Beere
Hencoop=Geflügelstall
Avianflu=Vogelgrippe
Pig=Schwein
Swineflu=Schweinegrippe
Bacon=Speck
Soap=Seife
Jungle=Dschungel
JungleBook=Dschungelbuch
Hero=Held
RobinHood=Robin Hood
Submarine=U-Boot
CaptainNemo=Captain Nemo
Island=Insel
Fat=Fett
Pilot=Pilot
Captain=Kapitän
Pirate=Pirat
Pirateship=Piratenschiff
Treasure=Schatz
Love=Liebe
Sandwich=Sandwich
McDonalds=McDonalds
Bow=Bogen
Dam=Damm
Beaver=Biber
Champagne=Sekt
Ceramics=Keramik
Ectoplasm=Ektoplasma
Reed=Schilf
Tobacco=Tabak
Cigarettes=Zigaretten
Cancer=Krebs
Smoke=Rauch
Alchemist=Alchemist
Gold=Gold
Radioactivity=Radioaktivität
Uranium=Uran
Plutonium=Plutonium
Atomicbomb=Atombombe
Hydrogenbomb=Wasserstoffbombe
Alien=Alien
Starship=Raumschiff
CaptainPicard=Captain Picard
USSEnterprise=USS Enterprise
Supernova=Supernova
Blackhole=Schwarzes Loch
Wormhole=Wurmloch
Void=Leere
BigBang=Urknall
BigCrunch=Big Crunch
Idea=Idee
StephenHawking=Stephen Hawking
AlbertEinstein=Albert Einstein
Relativitytheory=Relativitätstheorie
Lamp=Lampe
Lavalamp=Lavalampe
Genie=Genie
Prisoner=Gefangener
Coral=Koralle
VWBeetle=VW Käfer
Toast=Toast
Explosion=Explosion
OneUP=1UP
Mario=Mario
Yoshi=Yoshi
Yoshiegg=Yoshi Egg
Team=Team
Boomushroom=Boo Mushroom
Computergame=Computerspiel
Luigi=Luigi
King=König
Leach=Lauge
LichKing=Lich König
Warcraft=Warcraft
Fireelemental=Elementarfeuer
Ant=Ameise
Termite=Termite
Insects=Insekten
Mosquito=Stechmücke
Mantis=Gottesanbeterin
Infestation=Plage
Robot=Roboter
Zerg=Zerg
Protoss=Protoss
Terran=Terran
Starcraft=Starcraft
QueenofBlades=Queen of Blades
Zeratul=Zeratul
JimRaynor=Jim Raynor
NeedforSpeed=Need for Speed
ResidentEvil=Resident Evil
TombRaider=Tomb Raider
LaraCroft=Lara Croft
Paint=Farbe
Fabergeegg=Fabergé-Ei
Easteregg=Osterei
Lighthouse=Leuchtturm
Frog=Frosch
Salamander=Salamander
Diet=Ernährung
Obesity=Fettleibigkeit
Rust=Rost
Phoenix=Phönix
Sniper=Heckenschütze
Sushi=Sushi
Vulture=Geier
Weevil=Rüsselkäfer
Undead=Untoter
Vinegar=Essig
Spinningwheel=Spinnrad
Yarn=Garn
Aluminium=Aluminium
Kangaroo=Känguruh
Russia=Russland
Romania=Rumänien
USA=USA
France=Frankreich
Germany=Deutschland
UK=Großbritannien
China=China
Egypt=Ägypten
Italy=Italien
SouthAfrica=Südafrika
Mexico=Mexiko
India=Indien
Japan=Japan
Iceland=Island
Switzerland=Schweiz
Australia=Australien
Dracula=Dracula
Somalia=Somalia
SaudiArabia=Saudi-Arabien
Napoleon=Napoleon
Antarctica=Antarktis
Brazil=Brasilien
Canada=Kanada
Norway=Norwegen
KarelCapek=Karel Čapek
CzechRepublic=Tschechische Republik
Sauna=Sauna
Finland=Finnland
Netherlands=Niederlande
Alcoholic=Alkoholiker
Ashtray=Aschenbecher
Tropics=Tropen
SugarCane=Zuckerrohr
Sugar=Zucker
Caramel=Karamell
Clock=Uhr
Firefighter=Feuerwehrmann
Firefly=Glühwürmchen
Juice=Saft
LightningRod=Blitzableiter
Mirror=Spiegel
Peat=Torf
SwissArmyKnife=Schweizer Taschenmesser
ScotchWhiskey=schottischer Whiskey
Scotland=Schottland
Samurai=Samurai
Rubber=Radiergummi
Ball=Ball
Football=Fußball
StarWars=StarWars
R2D2=R2D2
C3PO=C3P0
Lobster=Hummer
Camel=Kamel
Statue=Statue
Monument=Monument
LibertyStatue=Freiheitsstatue
EiffelTower=Eiffelturm
Colosseum=Kolosseum
BigBen=Big Ben
TajMahal=Taj Mahal
Playcards=Spielkarte
Jellyfish=Meduse
Ambulance=Krankenwagen
Sound=Klang
Music=Musik
Guitar=Guitarre
GuitarHero=Guitar hero
Sport=Sport
F1=Formel 1
Gymnastics=Gymnastik
TableTennis=Tischtennis
AmericanFootball=Amerikanische
Hockey=Eishockey
Rugby=Rugby
Ferrari=Ferrari
Ford=Ford
Mercedes=Mercedes
Audi=Audi
BWM=BMW
Renault=Renault
Nissan=Nissan
Toyota=Toyota
Cricket=Kricket
ManUtd=Manchester United
Chelsea=Chelsea
Arsenal=Arsenal
Liverpool=Liverpool
Picture=Bild
Camera=Kamera
Movie=Film
Theater=Theater
Oscar=Oscar
Linux=Linux
Artist=Artist
Hail=Hail
Airport=Airport
Geek=Geek
Nerd=Nerd
Blowfish=Blowfish
Musician=Musician
Astronaut=Astronaut
Science=Science
Chemistry=Chemistry
Biology=Biology
Physics=Physics
Geology=Geology
Paleontology=Paleontology
Astronomy=Astronomy
CharlesDarwin=Charles Darwin
MobyDick=Moby Dick
Chalk=Chalk
Blackboard=Blackboard
Student=Student
School=School
Schoolbus=Schoolbus
Soundofmusic=Sound of Music
Money=Money
Economy=Economy
Economics=Economics
Dollar=Dollar
Euro=Euro
Pound=Pound
Europe=Europe
Bank=Bank
Vault=Vault
Plastic=Plastic
Creditcard=Creditcard
Box=Box
Container=Container
Cargo=Cargo
Safe=Safe
Depositbox=Deposit box
Toolbox=Toolbox
Basket=Basket
Basketball=Basketball
Helmet=Helmet
Work=Work
Worker=Worker
Company=Company
Factory=Factory
Product=Product
Christmas=Christmas
Gift=Gift
Giftbox=Giftbox
Soundmixer=Sound mixer
Speakers=Speakers
Language=Language
Linguistics=Linguistics