Fire=אש
Water=מים
Air=אוויר
Earth=אדמה
Ocean=אוקיינוס
Lava=לבה
Volcano=הר געש
Pressure=לחץ
Ash=אפר
Stone=אבן
Metal=מתכת
Wind=רוח
Swamp=ביצה
Energy=אנרגיה
Life=חיים
Algae=אצות
Bacteria=בקטריה
Worm=תולעת
Sulfur=גופרית
Ghost=רוח רפאים
Steam=אדים
Sand=חול
Dust=אבק
Gunpowder=אבק שריפה
Mud=בוץ
Mite=ברחש
Seed=זרע
Clay=חמר
Glass=זכוכית
Snake=נחש
Beach=חוף ים
Desert=מדבר
Silicon=סיליקון
Hourglass=שעון חול
Tree=עץ
Egg=ביצה
Lizard=לטאה
Beast=חיה
Monkey=קוף
Man=בן אדם
Grove=חורשה
Forest=יער
Tool=כלי עבודה
Livestock=משק חי
Bear=דב
Panda=פנדה
Shark=כריש
Bird=ציפור
Omelette=אומלט
Turtle=צב
Tortoise=צב יבשה
Fish=דג
Caviar=קוויאר
Dinosaur=דינוזאור
Chicken=תרנגולת
Transistor=טרנזיסטור
Chip=שבב
Computer=מחשב
Radio=רדיו
Radar=רדאר
Ice=קרח
PolarBear=דב קוטב
Hippopotamus=היפופוטם
Tornado=טורנדו
Storm=סופה
Cloud=ענן
Sky=שמים
Rain=גשם
Thunderstorm=סופת רעמים
Snow=שלג
Electricity=חשמל
Lightbulb=נורה
Light=אור
Rainbow=קשת בענן
Sun=שמש
Penguin=פינגווין
Brick=לבנה
Beetle=חיפושית
Mushroom=פטריה
Flower=פרח
Fruit=פרי
Watermelon=אבטיח
Moon=ירח
Planet=כוכב לכת
Solarsystem=מערכת השמש
Galaxy=גלקסיה
Universe=יקום
Butterfly=פרפר
Fly=זבוב
Dragonfly=שפירית
Plesiosaur=פלזיוזאור
Pterosaur=פטרוזאור
Dragon=דרקון
Tiger=נמר
Star=כוכב
Starfish=כוכב ים
Arm=נשק
Lightsaber=חרב אור
Firearm=כלי יריה
Hunter=צייד
Warrior=לוחם
Soldier=חייל
Cactus=קקטוס
Fisherman=דייג
Poison=רעל
Lichen=חזזית
Corpse=גופה
Fugu=דג פוגו
Assassin=מתנקש
Sith=סית
Jedi=ג'די
DarthVader=דארת ויידר
Poisonedweapon=נשק רעיל
Plankton=פלנגטון
Whale=לויתן
Shell=צדף
Limestone=אבן גיר
Pearl=פנינה
Snail=חילזון
Lime=גיר
Cement=מלט
Concrete=בטון
Mold=עובש
Cheese=גבינה
Mouse=עכבר
Cat=חתול
TomandJerry=תום וג'רי
Fondue=פונדו
Moss=אזוב
Fern=שרך
Fossil=מאובן
Grass=דשא
Milk=חלב
Manure=דשן
Yogurt=יוגורט
Flu=שפעת
Ozone=אוזון
Airplane=מטוס
Arable=אדמה מעובדת
Geyser=גייזר
Wheat=חיטה
Flour=קמח
Dough=בצק
Bread=לחם
Pizza=פיצה
Pie=פאי
Kerogen=קרוגן
Bitumen=ביטומן
Petroleum=נפט
Gasoline=דלק
Scorpion=עקרב
Cochineal=כנימה
Carmine=כרמין
Scarab=חיפושית פרעה
TheBeatles=הביטלס
Wheel=גלגל
Bicycle=אופניים
Wagon=כרכרה
Coal=פחם
Uncutdiamond=יהלום לא מלוטש
Diamond=יהלום
Boiler=דוד
Steamengine=מנוע קיטור
Combustionengine=מנוע
Locomotive=קטר
Car=מכונית
Motorcycle=אופנוע
Motorboat=סירת מנוע
Boat=סירה
Woodenship=ספינה מעץ
Steamer=ספינת קיטור
Wood=עץ
Coffin=ארון קבורה
Pinocchio=פינוקיו
Grape=ענבים
Yeast=שמרים
Alcohol=אלכוהול
Wine=יין
Beer=בירה
Tequila=טקילה
Vodka=וודקה
Perfume=בושם
Paper=נייר
Book=ספר
Library=ספרייה
Hut=ביקתה
House=בית
Skyscraper=גורד שחקים
City=עיר
Country=מדינה
Continent=יבשת
Time=זמן
Oldman=אדם זקן
Christmastree=עץ חג המולד
Santaclaus=סנטה קלאוס
Snowman=איש שלג
Scientist=מדען
Penicillin=פנצילין
Meat=בשר
Wool=צמר
Cloth=בד
Clothing=בגדים
Knife=סכין
Scissors=מספריים
Hydrogen=מימן
Oxygen=חמצן
Carbondioxide=פחמן דו חמצני
Sodawater=סודה
CocaCola=קוקה קולה
Barbeque=ברביקיו
Mummy=מומיה
Pyramid=פירמידה
Anubis=אנוביס
Pharaoh=פרעה
Zombie=זומבי
Frankenstein=פרנקנשטיין
Grave=קבר
Cemetery=בית קברות
Blood=דם
Sailboat=מפרשית
Sick=חולה
Hospital=בית חולים
Museum=מוזיאון
Bar=פאב
Zoo=גן חיות
Feather=נוצה
Pillow=כרית
Quetzalcoatl=קצאלקואטל
Bat=עטלף
Batman=באטמן
Vampire=ערפד
Werewolf=אדם זאב
TwilightSaga=דמדומים
Sex=סקס
SexandtheCity=סקס והעיר הגדולה
Kamasutra=קאמה סוטרה
Chariot=מרכבה
Berry=תות
Hencoop=לול תרנגולות
Avianflu=שפעת העופות
Pig=חזיר
Swineflu=שפעת החזירים
Bacon=בייקון
Soap=סבון
Jungle=ג'ונגל
JungleBook=ספר הג'ונגל
Hero=גיבור
RobinHood=רובין הוד
Submarine=צוללת
CaptainNemo=קפטין נמו
Island=אי
Fat=שומן
Pilot=טייס
Captain=קפטין
Pirate=פיראט
Pirateship=ספינת פיראטים
Treasure=אוצר
Love=אהבה
Sandwich=סנדביץ
McDonalds=מקדונלדס
Bow=קשת
Dam=סכר
Beaver=בונה
Champagne=שמפניה
Ceramics=כלי חרס
Ectoplasm=אקטופלסמה
Reed=סוף
Tobacco=טבק
Cigarettes=סיגריות
Cancer=סרטן
Smoke=עשן
Alchemist=אלכימאי
Gold=זהב
Radioactivity=רדיואקטיביות
Uranium=אורניום
Plutonium=פלוטוניום
Atomicbomb=פצצה אטומית
Hydrogenbomb=פצצת מימן
Alien=חייזר
Starship=חללית
CaptainPicard=קפטן פיקרד
USSEnterprise=האנטרפרייז
Supernova=סופרנובה
Blackhole=חור שחור
Wormhole=חור תולעת
Void=ריק
BigBang=המפץ הגדול
BigCrunch=Big Crunch
Idea=רעיון
StephenHawking=סטיבן הוקינג
AlbertEinstein=אלברט איינשטיין
Relativitytheory=תורת היחסות
Lamp=עששית
Lavalamp=מנורת לבה
Genie=ג'יני
Prisoner=אסיר
Coral=אלמוג
VWBeetle=פולקסווגן חיפושית
Toast=טוסט
Explosion=פיצוץ
OneUP=1UP
Mario=מריו
Yoshi=יושי
Yoshiegg=ביצת יושי
Team=קבוצה
Boomushroom=הפטרייה בו
Computergame=משחק מחשב
Luigi=לואיג'י
King=מלך
Leach=ליץ'
LichKing=המלך ליץ'
Warcraft=וורקראפט
Fireelemental=אלמנט האש
Ant=נמלה
Termite=טרמיט
Insects=חרקים
Mosquito=יתוש
Mantis=גמל שלמה
Infestation=שריצה
Robot=רובוט
Zerg=sc זרג
Protoss=sc פרוטוס
Terran=sc טראן
Starcraft=סטארקרפט
QueenofBlades=sc מלכת הלהבים
Zeratul=sc זרטול
JimRaynor=ג'ים ריינור
NeedforSpeed=Need for Speed
ResidentEvil=רזידנט איוול
TombRaider=טומב ריידר
LaraCroft=לארה קרופט
Paint=צבע
Fabergeegg=ביצת פברז'ה
Easteregg=ביצת פסחא
Lighthouse=מגדלור
Frog=צפרדע
Salamander=סלמנדרה
Diet=דיאטה
Obesity=השמנה
Rust=חלודה
Phoenix=עוף חול
Sniper=צלף
Sushi=סושי
Vulture=עיט
Weevil=חדקונית
Undead=אל-מת
Vinegar=חומץ
Spinningwheel=גלגל טוויה
Yarn=חוט
Aluminium=אלומיניום
Kangaroo=קנגרו
Russia=רוסיה
Romania=רומניה
USA=ארצות הברית
France=צרפת
Germany=גרמניה
UK=אנגליה
China=סין
Egypt=מצרים
Italy=איטליה
SouthAfrica=דרום אפריקה
Mexico=מקסיקו
India=הודו
Japan=יפן
Iceland=איסלנד
Switzerland=שוויץ
Australia=אוסטרליה
Dracula=דרקולה
Somalia=סומליה
SaudiArabia=ערב הסעודית
Napoleon=נפוליאון
Antarctica=אנטרקטיקה
Brazil=ברזיל
Canada=קנדה
Norway=נורבגיה
KarelCapek=קרל צ'אפק
CzechRepublic=צ'כיה
Sauna=סאונה
Finland=פינלנד
Netherlands=הולנד
Alcoholic=אלכוהוליסט
Ashtray=מאפרה
Tropics=האיים הטרופיים
SugarCane=קנה סוכר
Sugar=סוכר
Caramel=קרמל
Clock=שעון
Firefighter=כבאי
Firefly=גחלילית
Juice=מיץ
LightningRod=לוכד ברקים
Mirror=מראה
Peat=כבול
SwissArmyKnife=אולר שוייצרי
ScotchWhiskey=וויסקי סקוטי
Scotland=סקוטלנד
Samurai=סמוראי
Rubber=גומי
Ball=כדור
Football=כדורגל
StarWars=מלחמת הכוכבים
R2D2=R2D2
C3PO=C3P0
Lobster=לובסטר
Camel=גמל
Statue=פסל
Monument=אנדרטה
LibertyStatue=פסל החירות
EiffelTower=מגדל אייפל
Colosseum=קולוסיאום
BigBen=ביג בן
TajMahal=טאג' מאהל
Playcards=קלפי משחק
Jellyfish=מדוזה
Ambulance=אמבולנס
Sound=קול
Music=מוזיקה
Guitar=גיטרה
GuitarHero=גיטר הירו
Sport=ספורט
F1=פורמולה 1
Gymnastics=התעמלות
TableTennis=טניס שולחן
AmericanFootball=פוטבול
Hockey=הוקי
Rugby=רוגבי
Ferrari=פרארי
Ford=פורד
Mercedes=מרצדס
Audi=אאודי
BWM=במו
Renault=רנו
Nissan=ניסאן
Toyota=טויוטה
Cricket=קריקט
ManUtd=מנצ'סטר יונייטד
Chelsea=צ'לסי
Arsenal=ארסנל
Liverpool=ליברפול
Picture=תמונה
Camera=מצלמה
Movie=סרט
Theater=תיאטרון
Oscar=אוסקר
Linux=לינוקס
Artist=אומן
Hail=ברד
Airport=שדה תעופה
Geek=גיק
Nerd=חנון
Blowfish=אבונפחא
Musician=מוסיקאי
Astronaut=אסטרונאוט
Science=מדע
Chemistry=כימיה
Biology=ביולוגיה
Physics=פיסיקה
Geology=גיאולוגיה
Paleontology=פליאונטולוגיה
Astronomy=אסטרונומיה
CharlesDarwin=צ'רלס דארווין	
MobyDick=מובי דיק
Chalk=גיר
Blackboard=לוח
Student=סטודנט
School=בית ספר
Schoolbus=אוטובוס תלמידים
Soundofmusic=צלילי המוזיקה
Money=כסף
Economy=כלכלה
Economics=כלכלן
Dollar=דולר
Euro=יורו
Pound=פאונד
Europe=אירופה
Bank=בנק
Vault=כספת בנק
Plastic=פלסטיק
Creditcard=כרטיס אשראי
Box=קופסה
Container=מיכל
Cargo=מטען
Safe=כספת
Depositbox=תיבת הפקדה
Toolbox=ארגז כלים
Basket=סל
Basketball=כדורסל
Helmet=קדסה
Work=עבודה
Worker=עובד
Company=חברה
Factory=מפעל
Product=מוצר
Christmas=חג המולד
Gift=מתנה
Giftbox=אריזת מתנה
Soundmixer=מיקסר
Speakers=רמקולים
Language=שפה
Linguistics=בלשנות