Fire=Tűz
Water=Víz
Air=Levegő
Earth=Föld
Ocean=Óceán
Lava=Láva
Volcano=Vulkán
Pressure=Nyomás
Ash=Hamu
Stone=Kő
Metal=Fém
Wind=Szél
Swamp=Mocsár
Energy=Energia
Life=Élet
Algae=Alga
Bacteria=Baktérium
Worm=Kukac
Sulfur=Kén
Ghost=Szellem
Steam=Gőz
Sand=Homok
Dust=Por
Gunpowder=Puskapor
Mud=Sár
Mite=Atka
Seed=Mag
Clay=Agyag
Glass=Üveg
Snake=Kígyó
Beach=Tengerpart
Desert=Sivatag
Silicon=Szilícium
Hourglass=Homokóra
Tree=Fa
Egg=Tojás
Lizard=Gyík
Beast=Vadállat
Monkey=Majom
Man=Ember
Grove=Liget
Forest=Erdő
Tool=Szerszám
Livestock=Haszonállat
Bear=Medve
Panda=Panda
Shark=Cápa
Bird=Madár
Omelette=Omlett
Turtle=Tengeri Teknős
Tortoise=Teknős
Fish=Hal
Caviar=Kaviár
Dinosaur=Dinoszaurusz
Chicken=Csirke
Transistor=Tranzisztor
Chip=Chip
Computer=Számítógép
Radio=Rádió
Radar=Radar
Ice=Jég
PolarBear=Jegesmedve
Hippopotamus=Víziló
Tornado=Tornádó
Storm=Vihar
Cloud=Felhő
Sky=Ég
Rain=Eső
Thunderstorm=Zivatar
Snow=Hó
Electricity=Elektromosság
Lightbulb=Villanykörte
Light=Fény
Rainbow=Szivárvány
Sun=Nap
Penguin=Pingvin
Brick=Tégla
Beetle=Bogár
Mushroom=Gomba
Flower=Virág
Fruit=Gyümölcs
Watermelon=Dinnye
Moon=Hold
Planet=Bolygó
Solarsystem=Naprendszer
Galaxy=Galaxis
Universe=Univerzum
Butterfly=Pillangó
Fly=Légy
Dragonfly=Szitakötő
Plesiosaur=Plezioszaurusz
Pterosaur=Pteroszaurusz
Dragon=Sárkány
Tiger=Tigris
Star=Csillag
Starfish=Tengeri csillag
Arm=Fegyver
Lightsaber=Fénykard
Firearm=Lőfegyver
Hunter=Vadász
Warrior=Harcos
Soldier=Katona
Cactus=Kaktusz
Fisherman=Halász
Poison=Méreg
Lichen=Zuzmó
Corpse=Hulla
Fugu=Gömbhal
Assassin=Bérgyilkos
Sith=Sith
Jedi=Jedi
DarthVader=Darth Vader
Poisonedweapon=Mérgezett fegyver
Plankton=Plankton
Whale=Bálna
Shell=Kagyló
Limestone=Mészkő
Pearl=Gyöngy
Snail=Csiga
Lime=Mész
Cement=Cement
Concrete=Beton
Mold=Penész
Cheese=Sajt
Mouse=Egér
Cat=Macska
TomandJerry=Tom & Jerry
Fondue=Fondü
Moss=Moha
Fern=Páfrány
Fossil=Kövület
Grass=Fű
Milk=Tej
Manure=Trágya
Yogurt=Joghurt
Flu=Influenza
Ozone=Ózon
Airplane=Repülőgép
Arable=Szántó
Geyser=Gejzír
Wheat=Búza
Flour=Liszt
Dough=Tészta
Bread=Kenyér
Pizza=Pizza
Pie=Pite
Kerogen=Kerogen
Bitumen=Bitumen
Petroleum=Kőolaj
Gasoline=Benzin
Scorpion=Skorpió
Cochineal=Bíbortetű
Carmine=Karmazsinvörös
Scarab=Ganajtúró
TheBeatles=A Beatles
Wheel=Kerék
Bicycle=Bicikli
Wagon=Kocsi
Coal=Szén
Uncutdiamond=Nyers gyémánt
Diamond=Csiszolt gyémánt
Boiler=Bojler
Steamengine=Gőzgép
Combustionengine=Belsőégésű motor
Locomotive=Lokomotív
Car=Autó
Motorcycle=Motorbicikli
Motorboat=Motorcsónak
Boat=Csónak
Woodenship=Fa hajó
Steamer=Gőzhajó
Wood=Fa(anyag)
Coffin=Koporsó
Pinocchio=Pinocchio
Grape=Szőlő
Yeast=Élesztő
Alcohol=Alkohol
Wine=Bor
Beer=Sör
Tequila=Tequila
Vodka=Vodka
Perfume=Parfüm
Paper=Papír
Book=Könyv
Library=Könyvtár
Hut=Kunyhó
House=Ház
Skyscraper=Felhőkarcoló
City=Város
Country=Ország
Continent=Kontinens
Time=Idő
Oldman=Öreg ember
Christmastree=Karácsonyfa
Santaclaus=Télapó
Snowman=Hóember
Scientist=Tudós
Penicillin=Penicillin
Meat=Hús
Wool=Gyapjú
Cloth=Ruhaanyag
Clothing=Ruházat
Knife=Kés
Scissors=Olló
Hydrogen=Hidrogén
Oxygen=Oxigén
Carbondioxide=Szén-dioxid
Sodawater=Szódavíz
CocaCola=Coca-Cola
Barbeque=Barbeque
Mummy=Múmia
Pyramid=Piramis
Anubis=Anubisz
Pharaoh=Fáraó
Zombie=Zombi
Frankenstein=Frankenstein
Grave=Sír
Cemetery=Temető
Blood=Vér
Sailboat=Vitorlás
Sick=Beteg
Hospital=Kórház
Museum=Múzeum
Bar=Bár
Zoo=Állatkert
Feather=Toll
Pillow=Párna
Quetzalcoatl=Quetzalcoatl
Bat=Denevér
Batman=Batman
Vampire=Vámpír
Werewolf=Vérfarkas
TwilightSaga=Twilight mondakör
Sex=Szex
SexandtheCity=Szex és New York
Kamasutra=Kámaszutra
Chariot=Harci szekér
Berry=Bogyó
Hencoop=Tyúk ól
Avianflu=Madár-influenza
Pig=Malac
Swineflu=Sertés-influenza
Bacon=Bacon
Soap=Szappan
Jungle=Dzsungel
JungleBook=Dzsungel könyve
Hero=Hős
RobinHood=Robin Hood
Submarine=Tengeralattjáró
CaptainNemo=Némó kapitány
Island=Sziget
Fat=Zsír
Pilot=Pilóta
Captain=Kapitány
Pirate=Kalóz
Pirateship=Kalózhajó
Treasure=Kincs
Love=Szerelem
Sandwich=Szendvics
McDonalds=McDonalds
Bow=Íj
Dam=Gát
Beaver=Hód
Champagne=Pezsgő
Ceramics=Kerámia
Ectoplasm=Ektoplazma
Reed=Nád
Tobacco=Dohány
Cigarettes=Cigaretta
Cancer=Rák
Smoke=Füst
Alchemist=Alkimista
Gold=Arany
Radioactivity=Radioaktivitás
Uranium=Urán
Plutonium=Plutónium
Atomicbomb=Atombomba
Hydrogenbomb=Hidrogén bomba
Alien=Alien
Starship=Csillaghajó
CaptainPicard=Picard kapitány
USSEnterprise=Enterprise űrhajó
Supernova=Szupernova
Blackhole=Fekete lyuk
Wormhole=Féreglyuk
Void=Üresség
BigBang=Nagy bumm
BigCrunch=Nagy összeroppanás
Idea=Ötlet
StephenHawking=Stephen Hawking
AlbertEinstein=Albert Einstein
Relativitytheory=Relativitás elmélet
Lamp=Lámpa
Lavalamp=Láva lámpa
Genie=Dzsinn
Prisoner=Rab
Coral=Korall
VWBeetle=VW Bogár
Toast=Pirítós
Explosion=Robbanás
OneUP=1UP
Mario=Mario
Yoshi=Yoshi
Yoshiegg=Yoshi tojás
Team=Csapat
Boomushroom=Szellem gomba
Computergame=Számítógépes játék
Luigi=Luigi
King=Király
Leach=Pióca
LichKing=Lich király
Warcraft=Warcraft
Fireelemental=Tűz elementál
Ant=Hangya
Termite=Termesz
Insects=Rovarok
Mosquito=Moszkitó
Mantis=Imádkozó sáska
Infestation=Fertőzés
Robot=Robot
Zerg=Zerg
Protoss=Protoss
Terran=Terran
Starcraft=Starcraft
QueenofBlades=Queen of Blades
Zeratul=Zeratul
JimRaynor=Jim Raynor
NeedforSpeed=Need for Speed
ResidentEvil=Resident Evil
TombRaider=Tomb Raider
LaraCroft=Lara Croft
Paint=Festék
Fabergeegg=Faberge tojás
Easteregg=Húsvéti tojás
Lighthouse=Világító torony
Frog=Béka
Salamander=Szalamandra
Diet=Diéta
Obesity=Elhízottság
Rust=Rozsda
Phoenix=Főnix
Sniper=Mesterlövész
Sushi=Szusi
Vulture=Keselyű
Weevil=Zsizsik
Undead=Élőholt
Vinegar=Ecet
Spinningwheel=Rokka
Yarn=Fonál
Aluminium=Alumínium
Kangaroo=Kenguru
Russia=Oroszország
Romania=Románia
USA=USA
France=Franciaország
Germany=Németország
UK=Egyesült királyság
China=Kína
Egypt=Egyiptom
Italy=Olaszország
SouthAfrica=Dél Afrika
Mexico=Mexikó
India=India
Japan=Japán
Iceland=Izland
Switzerland=Svájc
Australia=Ausztrália
Dracula=Drakula
Somalia=Szomália
SaudiArabia=Szaud-Arábia
Napoleon=Napóleon
Antarctica=Antarktisz
Brazil=Brazília
Canada=Kanada
Norway=Norvégia
KarelCapek=Karel Čapek
CzechRepublic=Csehország
Sauna=Szauna
Finland=Finnország
Netherlands=Hollandia
Alcoholic=Alkoholista
Ashtray=Hamutartó
Tropics=Trópusok
SugarCane=Cukornád
Sugar=Cukor
Caramel=Karamell
Clock=Óra
Firefighter=Tűzoltó
Firefly=Szentjánosbogár
Juice=Dzsúsz
LightningRod=Villámhárító
Mirror=Tükör
Peat=Tőzeg
SwissArmyKnife=Svájci bicska
ScotchWhiskey=Skót whiskey
Scotland=Skócia
Samurai=Szamuráj
Rubber=Gumi
Ball=Labda
Football=Foci
StarWars=Csillagok Háborúja
R2D2=R2D2
C3PO=C3P0
Lobster=Homár
Camel=Teve
Statue=Szobor
Monument=Emlékmű
LibertyStatue=Szabadság szobor
EiffelTower=Eiffel Torony
Colosseum=Kolosszeum
BigBen=Big Ben
TajMahal=Taj Mahal
Playcards=Játékkártya
Jellyfish=Medúza
Ambulance=Mentő
Sound=Hang
Music=Zene
Guitar=Gitár
GuitarHero=Guitar Hero
Sport=Sport
F1=Formula 1
Gymnastics=Torna
TableTennis=Asztali tenisz
AmericanFootball=Amerikai foci
Hockey=Hoki
Rugby=Rögbi
Ferrari=Ferrari
Ford=Ford
Mercedes=Mercedes
Audi=Audi
BWM=BMW
Renault=Renault
Nissan=Nissan
Toyota=Toyota
Cricket=Krikett
ManUtd=Manchester United
Chelsea=Chelsea
Arsenal=Arsenal
Liverpool=Liverpool
Picture=Kép
Camera=Fényképezőgép
Movie=Mozi
Theater=Színház
Oscar=Oscar-díj
Linux=Linux
Artist=Művész
Hail=Jégeső
Airport=Repülőtér
Geek=Kocka
Nerd=Stréber
Blowfish=Gömbhal
Musician=Zenész
Astronaut=Űrhajós
Science=Tudomány
Chemistry=Kémia
Biology=Biológia
Physics=Fizika
Geology=Földrajz
Paleontology=Paleontológia
Astronomy=Csillagászat
CharlesDarwin=Charles Darwin
MobyDick=Moby Dick
Chalk=Kréta
Blackboard=Iskolai tábla
Student=Tanuló
School=Iskola
Schoolbus=Iskola busz
Soundofmusic=A muzsika hangja
Money=Pénz
Economy=Gazdaság
Economics=Közgazdaságtan
Dollar=Dollár
Euro=Euró
Pound=Angol font
Europe=Európa
Bank=Bank
Vault=Páncélterem
Plastic=Műanyag
Creditcard=Bankkártya
Box=Doboz
Container=Konténer
Cargo=Rakomány
Safe=Széf
Depositbox=Páncélszekrény
Toolbox=Szerszámos láda
Basket=Kosár
Basketball=Kosárlabda
Helmet=Sisak
Work=Munka
Worker=Munkás
Company=Cég
Factory=Gyár
Product=Termék
Christmas=Karácsony
Gift=Ajándék
Giftbox=Ajándék doboz
Soundmixer=Hang keverő
Speakers=Hangfal
Language=Nyelv
Linguistics=Nyelvészet