Fire=Api
Water=Air
Air=Udara
Earth=Tanah
Ocean=Samudra
Lava=Lava
Volcano=Gunung Berapi
Pressure=Tekanan
Ash=Abu
Stone=Batu
Metal=Logam
Wind=Angin
Swamp=Rawa
Energy=Energi
Life=Kehidupan
Algae=Alga
Bacteria=Bakteri
Worm=Cacing
Sulfur=Belerang
Ghost=Hantu
Steam=Uap
Sand=Pasir
Dust=Debu
Gunpowder=Bubuk Mesiu
Mud=Lumpur
Mite=Tungau
Seed=Bibit
Clay=Tanah Liat
Glass=Kaca
Snake=Ular
Beach=Pantai
Desert=Gurun
Silicon=Silikon
Hourglass=Jam Pasir
Tree=Pohon
Egg=Telur
Lizard=Kadal
Beast=Binatang
Monkey=Monyet
Man=Manusia
Grove=Belukar
Forest=Hutan
Tool=Alat
Livestock=Ternak
Bear=Beruang
Panda=Panda
Shark=Hiu
Bird=Burung
Omelette=Telur Dadar
Turtle=Penyu
Tortoise=Kura-Kura
Fish=Ikan
Caviar=Kaviar
Dinosaur=Dinosaurus
Chicken=Ayam
Transistor=Transistor
Chip=Cip
Computer=Komputer
Radio=Radio
Radar=Radar
Ice=Es
PolarBear=Beruang Kutub
Hippopotamus=Kuda Nil
Tornado=Tornado
Storm=Badai
Cloud=Awan
Sky=Langit
Rain=Hujan
Thunderstorm=Hujan Badai
Snow=Salju
Electricity=Listrik
Lightbulb=Bohlam
Light=Cahaya
Rainbow=Pelangi
Sun=Matahari
Penguin=Penguin
Brick=Bata
Beetle=Kumbang
Mushroom=Jamur
Flower=Bunga
Fruit=Buah
Watermelon=Semangka
Moon=Bulan
Planet=Planet
Solarsystem=Tata Surya
Galaxy=Galaksi
Universe=Jagat Raya
Butterfly=Kupu-Kupu
Fly=Lalat
Dragonfly=Capung
Plesiosaur=Plesiosaur
Pterosaur=Pterosaur
Dragon=Naga
Tiger=Harimau
Star=Bintang
Starfish=Bintang Laut
Arm=Senjata
Lightsaber=Lightsaber
Firearm=Senjata Api
Hunter=Pemburu
Warrior=Prajurit
Soldier=Tentara
Cactus=Kaktus
Fisherman=Nelayan
Poison=Racun
Lichen=Lumut Kerak
Corpse=Mayat
Fugu=Ikan Fugu
Assassin=Pembunuh
Sith=Sith
Jedi=Jedi
DarthVader=Darth Vader
Poisonedweapon=Senjata Beracun
Plankton=Plankton
Whale=Paus
Shell=Cangkang
Limestone=Batu Gamping
Pearl=Mutiara
Snail=Siput
Lime=Kapur
Cement=Semen
Concrete=Beton
Mold=Kapang
Cheese=Keju
Mouse=Tikus
Cat=Kucing
TomandJerry=Tom and Jerry
Fondue=Fondue
Moss=Lumut
Fern=Tumbuhan Paku
Fossil=Fosil
Grass=Rumput
Milk=Susu
Manure=Pupuk Kandang
Yogurt=Yogurt
Flu=Flu
Ozone=Ozon
Airplane=Pesawat
Arable=Lahan Subur
Geyser=Geyser
Wheat=Gandum
Flour=Tepung
Dough=Adonan
Bread=Roti
Pizza=Pizza
Pie=Pai
Kerogen=Kerosin
Bitumen=Bitumen
Petroleum=Minyak Tanah
Gasoline=Bensin
Scorpion=Kalajengking
Cochineal=Cochineal
Carmine=Merah Tua
Scarab=Kumbang Mesir
TheBeatles=The Beatles
Wheel=Roda
Bicycle=Sepeda
Wagon=Gerobak
Coal=Batu Bara
Uncutdiamond=Berlian Mentah
Diamond=Berlian
Boiler=Ketel
Steamengine=Mesin Uap
Combustionengine=Mesin Pembakaran
Locomotive=Lokomotif
Car=Mobil
Motorcycle=Sepeda Motor
Motorboat=Perahu Motor
Boat=Perahu
Woodenship=Perahu Kayu
Steamer=Kapal Api
Wood=Kayu
Coffin=Peti Mati
Pinocchio=Pinokio
Grape=Anggur
Yeast=Ragi
Alcohol=Alkohol
Wine=Anggur (minuman)
Beer=Bir
Tequila=Tequila
Vodka=Vodka
Perfume=Parfum
Paper=Kertas
Book=Buku
Library=Perpustakaan
Hut=Pondok
House=Rumah
Skyscraper=Gedung Pencakar Langit
City=Kota
Country=Negara
Continent=Benua
Time=Waktu
Oldman=Orang Tua
Christmastree=Pohon Natal
Santaclaus=Sinterklas
Snowman=Manusia Salju
Scientist=Ilmuwan
Penicillin=Penisilin
Meat=Daging
Wool=Wol
Cloth=Kain
Clothing=Pakaian
Knife=Pisau
Scissors=Gunting
Hydrogen=Hidrogen
Oxygen=Oksigen
Carbondioxide=Karbon Dioksida
Sodawater=Air Berkarbonasi
CocaCola=Coca Cola
Barbeque=Barbekyu
Mummy=Mumi
Pyramid=Piramid
Anubis=Anubis
Pharaoh=Firaun
Zombie=Zombi
Frankenstein=Frankenstein
Grave=Makam
Cemetery=Pemakaman
Blood=Darah
Sailboat=Perahu Layar
Sick=Penyakit
Hospital=Rumah Sakit
Museum=Museum
Bar=Bar
Zoo=Kebun Binatang
Feather=Bulu
Pillow=Bantal
Quetzalcoatl=Quetzalcoatl
Bat=Kelelawar
Batman=Batman
Vampire=Vampir
Werewolf=Manusia Serigala
TwilightSaga=Twilight Saga
Sex=Seks
SexandtheCity=Sex and the City
Kamasutra=Kamasutra
Chariot=Kereta Perang
Berry=Beri (buah)
Hencoop=Kandang Ayam
Avianflu=Flu Burung
Pig=Babi
Swineflu=Flu Babi
Bacon=Daging Asap
Soap=Sabun
Jungle=Rimba
JungleBook=Jungle Book
Hero=Pahlawan
RobinHood=Robin Hood
Submarine=Kapal Selam
CaptainNemo=Captain Nemo
Island=Pulau
Fat=Lemak
Pilot=Pilot
Captain=Kapten
Pirate=Perompak
Pirateship=Kapal Perompak
Treasure=Harta Karun
Love=Cinta
Sandwich=Roti Isi
McDonalds=McDonalds
Bow=Panah
Dam=Bendungan
Beaver=Berang-Berang
Champagne=Sempanye
Ceramics=Keramik
Ectoplasm=Ektoplasma
Reed=Alang-Alang
Tobacco=Tembakau
Cigarettes=Rokok
Cancer=Kanker
Smoke=Asap
Alchemist=Ahli Alkimia
Gold=Emas
Radioactivity=Radioaktif
Uranium=Uranium
Plutonium=Plutonium
Atomicbomb=Bom Atom
Hydrogenbomb=Bom Hidrogen
Alien=Alien
Starship=Pesawat Luar Angkasa
CaptainPicard=Captain Picard
USSEnterprise=USS Enterprise
Supernova=Supernova
Blackhole=Lubang Hitam
Wormhole=Lubang Cacing
Void=Ruang Hampa
BigBang=Ledakan Besar
BigCrunch=Remukan Besar
Idea=Ide
StephenHawking=Stephen Hawking
AlbertEinstein=Albert Einstein
Relativitytheory=Teori Relativitas
Lamp=Lampu
Lavalamp=Lampu Lava
Genie=Jin
Prisoner=Tahanan
Coral=Koral
VWBeetle=VW Beetle
Toast=Roti Bakar
Explosion=Ledakan
OneUP=1UP
Mario=Mario
Yoshi=Yoshi
Yoshiegg=Yoshi egg
Team=Tim
Boomushroom=Boo mushroom
Computergame=Permainan Komputer
Luigi=Luigi
King=Raja
Leach=Lintah
LichKing=Lich King
Warcraft=Warcraft
Fireelemental=Fire elemental
Ant=Semut
Termite=Rayap
Insects=Serangga
Mosquito=Nyamuk
Mantis=Belalang
Infestation=Infestasi
Robot=Robot
Zerg=Zerg
Protoss=Protoss
Terran=Terran
Starcraft=Starcraft
QueenofBlades=Queen of Blades
Zeratul=Zeratul
JimRaynor=Jim Raynor
NeedforSpeed=Need for Speed
ResidentEvil=Resident Evil
TombRaider=Tomb Raider
LaraCroft=Lara Croft
Paint=Cat
Fabergeegg=Faberge Egg
Easteregg=Telur Paskah
Lighthouse=Mercusuar
Frog=Katak
Salamander=Salamander
Diet=Diet
Obesity=Obesitas
Rust=Karat
Phoenix=Phoenix
Sniper=Penembak Jitu
Sushi=Sushi
Vulture=Burung Nasar
Weevil=Kutu Beras
Undead=Mayat Hidup
Vinegar=Cuka
Spinningwheel=Pemintal
Yarn=Benang
Aluminium=Aluminium
Kangaroo=Kangguru
Russia=Rusia
Romania=Rumania
USA=Amerika Serikat
France=Perancis
Germany=Jerman
UK=Inggris
China=Cina
Egypt=Mesir
Italy=Italia
SouthAfrica=Afrika Selatan
Mexico=Meksiko
India=India
Japan=Jepang
Iceland=Eslandia
Switzerland=Swiss
Australia=Australia
Dracula=Drakula
Somalia=Somalia
SaudiArabia=Arab Saudi
Napoleon=Napoleon
Antarctica=Antartika
Brazil=Brasilia
Canada=Kanada
Norway=Norwegia
KarelCapek=Karel Čapek
CzechRepublic=Republik Ceko
Sauna=Sauna
Finland=Finlandia
Netherlands=Belanda
Alcoholic=Pemabuk
Ashtray=Asbak
Tropics=Tropis
SugarCane=Tebu
Sugar=Gula
Caramel=Karamel
Clock=Jam
Firefighter=Pemadam Kebakaran
Firefly=Kunang-Kunang
Juice=Jus
LightningRod=Penangkal Petir
Mirror=Cermin
Peat=Gambut
SwissArmyKnife=Pisau Swiss
ScotchWhiskey=Wiski Skotlandia
Scotland=Skotlandia
Samurai=Samurai
Rubber=Karet
Ball=Bola
Football=Sepak Bola
StarWars=StarWars
R2D2=R2D2
C3PO=C3P0
Lobster=Lobster
Camel=Unta
Statue=Patung
Monument=Monumen
LibertyStatue=Patung Liberty
EiffelTower=Menara Eiffel
Colosseum=Colosseum
BigBen=Big Ben
TajMahal=Taj Mahal
Playcards=Kartu Remi
Jellyfish=Ubur-Ubur
Ambulance=Ambulans
Sound=Suara
Music=Musik
Guitar=Gitar
GuitarHero=Guitar hero
Sport=Olahraga
F1=Formula 1
Gymnastics=Senam
TableTennis=Tenis Meja
AmericanFootball=American football
Hockey=Hoki (olahraga)
Rugby=Rugby
Ferrari=Ferrari
Ford=Ford
Mercedes=Mercedes
Audi=Audi
BWM=BMW
Renault=Renault
Nissan=Nissan
Toyota=Toyota
Cricket=Kriket
ManUtd=Manchester United
Chelsea=Chelsea
Arsenal=Arsenal
Liverpool=Liverpool
Picture=Gambar
Camera=Kamera
Movie=Film
Theater=Bioskop
Oscar=Oscar
Linux=Linux
Artist=Seniman
Hail=Hujan Es
Airport=Bandara
Geek=Maniak Komputer
Nerd=Kutu Buku
Blowfish=Ikan Buntal
Musician=Musisi
Astronaut=Astronot
Science=Sains
Chemistry=Kimia
Biology=Biologi
Physics=Fisika
Geology=Geologi
Paleontology=Paleontologi
Astronomy=Astronomi
CharlesDarwin=Charles Darwin
MobyDick=Moby Dick
Chalk=Kapur
Blackboard=Papan Tulis
Student=Murid
School=Sekolah
Schoolbus=Bus Sekolah
Soundofmusic=Sound of Music
Money=Uang
Economy=Ekonomi
Economics=Ekonomis
Dollar=Dolar
Euro=Euro
Pound=Poundsterling
Europe=Eropa
Bank=Bank
Vault=Brankas Bank
Plastic=Plastik
Creditcard=Kartu Kredit
Box=Kotak
Container=Kontainer
Cargo=Kargo
Safe=Brankas
Depositbox=Kotak Deposito
Toolbox=Kotak Perkakas
Basket=Keranjang
Basketball=Bola Basket
Helmet=Helm
Work=Kerja
Worker=Pekerja
Company=Perusahaan
Factory=Pabrik
Product=Produk
Christmas=Natal
Gift=Hadiah
Giftbox=Kotak Hadiah
Soundmixer=Audio mixer
Speakers=Pengeras Suara
Language=Bahasa
Linguistics=Linguistik