Fire=Fuoco
Water=Acqua
Air=Aria
Earth=Terra
Ocean=Oceano
Lava=Lava
Volcano=Vulcano
Pressure=Pressione
Ash=Cenere
Stone=Pietra
Metal=Metallo
Wind=Vento
Swamp=Palude
Energy=Energia
Life=Vita
Algae=Alga
Bacteria=Batterio
Worm=Verme
Sulfur=Zolfo
Ghost=Fantasma
Steam=Vapore
Sand=Sabbia
Dust=Polvere
Gunpowder=Polvere da sparo
Mud=Fango
Mite=Acaro
Seed=Seme
Clay=Argilla
Glass=Vetro
Snake=Serpente
Beach=Spiaggia
Desert=Deserto
Silicon=Silicio
Hourglass=Clessidra
Tree=Albero
Egg=Uovo
Lizard=Lucertola
Beast=Animale
Monkey=Scimmia
Man=Uomo
Grove=Bosco
Forest=Foresta
Tool=Attrezzo
Livestock=Bestiame
Bear=Orso
Panda=Panda
Shark=Squalo
Bird=Uccello
Omelette=Frittata
Turtle=Testuggine
Tortoise=Tartaruga
Fish=Pesce
Caviar=Caviale
Dinosaur=Dinosauro
Chicken=Pollo
Transistor=Transistor
Chip=Chip
Computer=Computer
Radio=Radio
Radar=Radar
Ice=Ghiaccio
PolarBear=Orso polare
Hippopotamus=Ippopotamo
Tornado=Tornado
Storm=Temporale
Cloud=Nuvola
Sky=Cielo
Rain=Pioggia
Thunderstorm=Tempesta di lampi
Snow=Neve
Electricity=Elettricità
Lightbulb=Lampadina
Light=Luce
Rainbow=Arcobaleno
Sun=Sole
Penguin=Pinguino
Brick=Mattone
Beetle=Scarafaggio
Mushroom=Fungo
Flower=Fiore
Fruit=Frutto
Watermelon=Anguria
Moon=Luna
Planet=Pianeta
Solarsystem=Sistema solare
Galaxy=Galassia
Universe=Universo
Butterfly=Farfalla
Fly=Mosca
Dragonfly=Libellula
Plesiosaur=Plesiosauro
Pterosaur=Pterosauro
Dragon=Drago
Tiger=Tigre
Star=Stella
Starfish=Stella marina
Arm=Arma
Lightsaber=Spada laser
Firearm=Arma da fuoco
Hunter=Cacciatore
Warrior=Guerriero
Soldier=Soldato
Cactus=Cactus
Fisherman=Pescatore
Poison=Veleno
Lichen=Lichene
Corpse=Cadavere
Fugu=Pesce palla
Assassin=Assassino
Sith=Sith
Jedi=Jedi
DarthVader=Darth Vader
Poisonedweapon=Arma avvelenata
Plankton=Plancton
Whale=Orca
Shell=Conchiglia
Limestone=Calcare
Pearl=Perla
Snail=Lumaca
Lime=Calce
Cement=Cemento
Concrete=Calcestruzzo
Mold=Muffa
Cheese=Formaggio
Mouse=Topo
Cat=Gatto
TomandJerry=Tom e Jerry
Fondue=Fonduta
Moss=Muschio
Fern=Felce
Fossil=Fossile
Grass=Erba
Milk=Latte
Manure=Letame
Yogurt=Yogurt
Flu=Influenza
Ozone=Ozono
Airplane=Aeroplano
Arable=Campo coltivato
Geyser=Geyser
Wheat=Grano
Flour=Farina
Dough=Pasta
Bread=Pane
Pizza=Pizza
Pie=Torta
Kerogen=Kerogene
Bitumen=Bitume
Petroleum=Petrolio
Gasoline=Benzina
Scorpion=Scorpione
Cochineal=Coccinella
Carmine=Carminio
Scarab=Scarabeo
TheBeatles=The Beatles
Wheel=Ruota
Bicycle=Bicicletta
Wagon=Carrozza
Coal=Carbone
Uncutdiamond=Diamante grezzo
Diamond=Diamante
Boiler=Caldaia
Steamengine=Motore a vapore
Combustionengine=Motore a combustione
Locomotive=Locomotiva
Car=Automobile
Motorcycle=Motocicletta
Motorboat=Motoscafo
Boat=Barca
Woodenship=Nave
Steamer=Piroscafo
Wood=Legno
Coffin=Bara
Pinocchio=Pinocchio
Grape=Uva
Yeast=Lievito
Alcohol=Alcol
Wine=Vino
Beer=Birra
Tequila=Tequila
Vodka=Vodka
Perfume=Profumo
Paper=Carta
Book=Libro
Library=Biblioteca
Hut=Capanna
House=Casa
Skyscraper=Grattacielo
City=Città
Country=Nazione
Continent=Continente
Time=Tempo
Oldman=Anziano
Christmastree=Albero di natale
Santaclaus=Babbo natale
Snowman=Pupazzo di neve
Scientist=Scienziato
Penicillin=Penicillina
Meat=Carne
Wool=Lana
Cloth=Tessuto
Clothing=Vestiti
Knife=Coltello
Scissors=Forbici
Hydrogen=Idrogeno
Oxygen=Ossigeno
Carbondioxide=Biossido di carbonio
Sodawater=Acqua gassata
CocaCola=Coca Cola
Barbeque=Barbeque
Mummy=Mummia
Pyramid=Piramide
Anubis=Anubi
Pharaoh=Faraone
Zombie=Zombie
Frankenstein=Frankenstein
Grave=Tomba
Cemetery=Cimitero
Blood=Sangue
Sailboat=Barca a vela
Sick=Malato
Hospital=Ospedale
Museum=Museo
Bar=Bar
Zoo=Zoo
Feather=Piuma
Pillow=Cuscino
Quetzalcoatl=Quetzalcoatl
Bat=Pipistrello
Batman=Batman
Vampire=Vampiro
Werewolf=Lupo mannaro
TwilightSaga=Saga di Twilight
Sex=Sesso
SexandtheCity=Sex and the City
Kamasutra=Kamasutra
Chariot=Biga
Berry=Bacca
Hencoop=Pollaio
Avianflu=Influenza aviaria
Pig=Maiale
Swineflu=Influenza suina
Bacon=Pancetta
Soap=Sapone
Jungle=Giungla
JungleBook=Libro della giungla
Hero=Eroe
RobinHood=Robin Hood
Submarine=Sommergibile
CaptainNemo=Capitano Nemo
Island=Isola
Fat=Grasso
Pilot=Pilota
Captain=Capitano
Pirate=Pirata
Pirateship=Nave pirata
Treasure=Tesoro
Love=Amore
Sandwich=Tramezzino
McDonalds=McDonalds
Bow=Arco
Dam=Diga
Beaver=Castoro
Champagne=Champagne
Ceramics=Ceramica
Ectoplasm=Ectoplasma
Reed=Canna
Tobacco=Tabacco
Cigarettes=Sigarette
Cancer=Cancro
Smoke=Fumo
Alchemist=Alchimista
Gold=Oro
Radioactivity=Radioattività
Uranium=Uranio
Plutonium=Plutonio
Atomicbomb=Bomba atomica
Hydrogenbomb=Bomba a idrogeno
Alien=Alieno
Starship=Astronave
CaptainPicard=Capitano Picard
USSEnterprise=USS Enterprise
Supernova=Supernova
Blackhole=Buco nero
Wormhole=Tunnel gravitazionale
Void=Vuoto
BigBang=Big Bang
BigCrunch=Big Crunch
Idea=Idea
StephenHawking=Stephen Hawking
AlbertEinstein=Albert Einstein
Relativitytheory=Teoria della relatività
Lamp=Lampada
Lavalamp=Lampada lava 
Genie=Genio
Prisoner=Prigioniero
Coral=Corallo
VWBeetle=Maggiolino
Toast=Toast
Explosion=Esplosione
OneUP=1UP
Mario=Mario
Yoshi=Yoshi
Yoshiegg=Uovo di yoshi
Team=Squadra
Boomushroom=Fungo fantasma
Computergame=Videogioco
Luigi=Luigi
King=Re
Leach=Sanguisuga
LichKing=Re dei lich
Warcraft=Warcraft
Fireelemental=Elementale del fuoco
Ant=Formica
Termite=Termite
Insects=Insetti
Mosquito=Zanzara
Mantis=Mantide
Infestation=Infestazione
Robot=Robot
Zerg=Zerg
Protoss=Protoss
Terran=Terran
Starcraft=Starcraft
QueenofBlades=Regina delle lame
Zeratul=Zeratul
JimRaynor=Jim Raynor
NeedforSpeed=Need for Speed
ResidentEvil=Resident Evil
TombRaider=Tomb Raider
LaraCroft=Lara Croft
Paint=Vernice
Fabergeegg=Uovo di Faberge
Easteregg=Uovo di pasqua
Lighthouse=Faro
Frog=Rana
Salamander=Salamandra
Diet=Dieta
Obesity=Obesità
Rust=Ruggine
Phoenix=Fenice
Sniper=Cecchino
Sushi=Sushi
Vulture=Avvoltoio
Weevil=Coleottero
Undead=Non morto
Vinegar=Aceto
Spinningwheel=Arcolaio
Yarn=Filato
Aluminium=Alluminio
Kangaroo=Canguro
Russia=Russia
Romania=Romania
USA=USA
France=Francia
Germany=Germania
UK=UK
China=Cina
Egypt=Egitto
Italy=Italia
SouthAfrica=Sud Africa
Mexico=Messico
India=India
Japan=Giappone
Iceland=Islanda
Switzerland=Svizzera
Australia=Australia
Dracula=Dracula
Somalia=Somalia
SaudiArabia=Arabia Saudita
Napoleon=Napoleone
Antarctica=Antartide
Brazil=Brasile
Canada=Canada
Norway=Norvegia
KarelCapek=Karel Čapek
CzechRepublic=Repubblica Ceca
Sauna=Sauna
Finland=Finlandia
Netherlands=Paesi Bassi
Alcoholic=Alcolico
Ashtray=Posacenere
Tropics=Tropici
SugarCane=Canna da zucchero
Sugar=Zucchero
Caramel=Caramello
Clock=Orologio
Firefighter=Vigile del fuoco
Firefly=Lucciola
Juice=Succo
LightningRod=Parafulmine
Mirror=Specchio
Peat=Torba
SwissArmyKnife=Coltellino svizzero
ScotchWhiskey=Scotch
Scotland=Scozia
Samurai=Samurai
Rubber=Gomma
Ball=Palla
Football=Calcio
StarWars=StarWars
R2D2=R2D2
C3PO=C3P0
Lobster=Lobster
Camel=Camel
Statue=Statue
Monument=Monument
LibertyStatue=Liberty Statue
EiffelTower=Eiffel Tower
Colosseum=Colosseum
BigBen=Big Ben
TajMahal=Taj Mahal
Playcards=Playcards
Jellyfish=Jellyfish
Ambulance=Ambulance
Sound=Sound
Music=Music
Guitar=Guitar
GuitarHero=Guitar hero
Sport=Sport
F1=Formula 1
Gymnastics=Gymnastics
TableTennis=Table tennis
AmericanFootball=American football
Hockey=Hockey
Rugby=Rugby
Ferrari=Ferrari
Ford=Ford
Mercedes=Mercedes
Audi=Audi
BWM=BMW
Renault=Renault
Nissan=Nissan
Toyota=Toyota
Cricket=Cricket
ManUtd=Manchester United
Chelsea=Chelsea
Arsenal=Arsenal
Liverpool=Liverpool
Picture=Picture
Camera=Camera
Movie=Movie
Theater=Theater
Oscar=Oscar
Linux=Linux
Artist=Artista
Hail=Grandine
Airport=Aeroporto
Geek=Geek
Nerd=Nerd
Blowfish=Pesce palla
Musician=Musicista
Astronaut=Astronauta
Science=Scienza
Chemistry=Chimica
Biology=Biologia
Physics=Fisica
Geology=Geologia
Paleontology=Paleontologia
Astronomy=Astronomia
CharlesDarwin=Charles Darwin
MobyDick=Moby Dick
Chalk=Gessetto
Blackboard=Lavagna
Student=Studente
School=Scuola
Schoolbus=Scuolabus
Soundofmusic=Musica
Money=Denaro
Economy=Economia
Economics=Scienze economiche
Dollar=Dollaro
Euro=Euro
Pound=Sterlina
Europe=Europa
Bank=Banca
Vault=Camera blindata
Plastic=Plastica
Creditcard=Carta di credito
Box=Scatola
Container=Container
Cargo=Merci
Safe=Cassaforte
Depositbox=Cass.di sicurezza
Toolbox=Cass.per attrezzi
Basket=Canestro
Basketball=Pallacanestro
Helmet=Elmetto
Work=Lavoro
Worker=Lavoratore
Company=Società
Factory=Fabbrica
Product=Prodotto
Christmas=Natale
Gift=Regalo
Giftbox=Scatola regalo
Soundmixer=Mixer audio
Speakers=Altoparlanti
Language=Linguaggio
Linguistics=Linguistica