Fire=Ogień
Water=Woda
Air=Powietrze
Earth=Ziemia
Ocean=Ocean
Lava=Lawa
Volcano=Wulkan
Pressure=Ciśnienie
Ash=Popiół
Stone=Kamień
Metal=Metal
Wind=Wiatr
Swamp=Bagno
Energy=Energia
Life=Życie
Algae=Glony
Bacteria=Bakteria
Worm=Robak
Sulfur=Siarka
Ghost=Duch
Steam=Para
Sand=Piasek
Dust=Pył
Gunpowder=Proch strzelniczy
Mud=Błoto
Mite=Roztocze
Seed=Ziarno
Clay=Glina
Glass=Szyba
Snake=Wąż
Beach=Plaża
Desert=Pustynia
Silicon=Krzem
Hourglass=Klepsydra
Tree=Drzewo
Egg=Jajko
Lizard=Jaszczurka
Beast=Bestia
Monkey=Małpa
Man=Człowiek
Grove=Gaj
Forest=Las
Tool=Narzędzie
Livestock=Zwierzę gospodarcze
Bear=Niedźwiedź
Panda=Panda
Shark=Rekin
Bird=Ptak
Omelette=Omlet
Turtle=Żółw morski
Tortoise=Żółw lądowy
Fish=Ryba
Caviar=Kawior
Dinosaur=Dinozaur
Chicken=Kurczak
Transistor=Tranzystor
Chip=Układ scalony
Computer=Komputer
Radio=Radio
Radar=Radar
Ice=Lód
PolarBear=Niedźwiedź polarny
Hippopotamus=Hipopotam
Tornado=Tornado
Storm=Sztorm
Cloud=Chmura
Sky=Niebo
Rain=Deszcz
Thunderstorm=Burza
Snow=Śnieg
Electricity=Elektryczność
Lightbulb=Żarówka
Light=Światło
Rainbow=Tęcza
Sun=Słońce
Penguin=Pingwin
Brick=Cegła
Beetle=Chrząszcz
Mushroom=Grzyb
Flower=Kwiat
Fruit=Owoc
Watermelon=Arbuz
Moon=Księżyc
Planet=Planeta
Solarsystem=Układ słoneczny
Galaxy=Galaktyka
Universe=Wszechświat
Butterfly=Motyl
Fly=Mucha
Dragonfly=Ważka
Plesiosaur=Plezjozaur
Pterosaur=Pterozaur
Dragon=Smok
Tiger=Tygrys
Star=Gwiazda
Starfish=Rozgwiazda
Arm=Miecz
Lightsaber=Miecz świetlny
Firearm=Broń
Hunter=Myśliwy
Warrior=Wojownik
Soldier=Żołnierz
Cactus=Kaktus
Fisherman=Rybak
Poison=Trucizna
Lichen=Porost
Corpse=Zwłoki
Fugu=Fugu
Assassin=Zabójca
Sith=Sithowie
Jedi=Jedi
DarthVader=Darth Vader
Poisonedweapon=Zatruta broń
Plankton=Plankton
Whale=Wieloryb
Shell=Muszla
Limestone=Wapień
Pearl=Perła
Snail=Ślimak
Lime=Wapno
Cement=Cement
Concrete=Beton
Mold=Pleśń
Cheese=Ser
Mouse=Mysz
Cat=Kot
TomandJerry=Tom i Jerry
Fondue=Fondue
Moss=Mech
Fern=Paproć
Fossil=Skamieniałość
Grass=Trawa
Milk=Mleko
Manure=Obornik
Yogurt=Jogurt
Flu=Grypa
Ozone=Ozon
Airplane=Samolot
Arable=Uprawy
Geyser=Gejzer
Wheat=Pszenica
Flour=Mąka
Dough=Ciasto
Bread=Chleb
Pizza=Pizza
Pie=Szarlotka
Kerogen=Kerogen
Bitumen=Bitumin
Petroleum=Ropa naftowa
Gasoline=Benzyna
Scorpion=Skorpion
Cochineal=Czerwiec kaktusowy
Carmine=Karmin
Scarab=Skarabeusz
TheBeatles=The Beatles
Wheel=Koło
Bicycle=Rower
Wagon=Wóz
Coal=Węgiel
Uncutdiamond=Nieoszlifowany diament
Diamond=Diament
Boiler=Kocioł
Steamengine=Silnik parowy
Combustionengine=Silnik spalinowy
Locomotive=Lokomotywa
Car=Samochód
Motorcycle=Motocykl
Motorboat=Motorówka
Boat=Łódź
Woodenship=Drewniany statek
Steamer=Parowiec
Wood=Drewno
Coffin=Trumna
Pinocchio=Pinokio
Grape=Winogrona
Yeast=Drożdże
Alcohol=Alkohol
Wine=Wino
Beer=Piwo
Tequila=Tequila
Vodka=Wódka
Perfume=Perfumy
Paper=Papier
Book=Książka
Library=Biblioteka
Hut=Chata
House=Dom
Skyscraper=Wieżowiec
City=Miasto
Country=Kraj
Continent=Kontynent
Time=Czas
Oldman=Starzec
Christmastree=Choinka
Santaclaus=Święty Mikołaj
Snowman=Bałwan
Scientist=Naukowiec
Penicillin=Penicylina
Meat=Mięso
Wool=Wełna
Cloth=Tkanina
Clothing=Odzież
Knife=Nóż
Scissors=Nożyczki
Hydrogen=Wodór
Oxygen=Tlen
Carbondioxide=Dwutlenek węgla
Sodawater=Woda sodowa
CocaCola=Coca-Cola
Barbeque=Gril
Mummy=Mumia
Pyramid=Piramida
Anubis=Anubis
Pharaoh=Faraon
Zombie=Zombie
Frankenstein=Frankenstein
Grave=Grób
Cemetery=Cmentarz
Blood=Krew
Sailboat=Żaglówka
Sick=Chory
Hospital=Szpital
Museum=Muzeum
Bar=Bar
Zoo=Zoo
Feather=Pióro
Pillow=Poduszka
Quetzalcoatl=Quetzalcoatl
Bat=Nietoperz
Batman=Batman
Vampire=Wampir
Werewolf=Wilkołak
TwilightSaga=Saga twilight
Sex=Seks
SexandtheCity=Seks w wielkim mieście
Kamasutra=Kamasutra
Chariot=Rydwan
Berry=Jagoda
Hencoop=Kurnik
Avianflu=Ptasia grypa
Pig=Świnia
Swineflu=Świńska grypa
Bacon=Boczek
Soap=Mydło
Jungle=Dżungli
JungleBook=Księga dżungli
Hero=Bohater
RobinHood=Robin Hood
Submarine=Łódź podwodna
CaptainNemo=Kapitan nemo
Island=Wyspa
Fat=Tłuszcz
Pilot=Pilot
Captain=Kapitan
Pirate=Pirat
Pirateship=Statek piracki
Treasure=Skarb
Love=Miłość
Sandwich=Kanapka
McDonalds=McDonald's
Bow=Łuk
Dam=Tama
Beaver=Bóbr
Champagne=Champagne
Ceramics=Ceramika
Ectoplasm=Ektoplazma
Reed=Trzcina
Tobacco=Tytoń
Cigarettes=Papierosy
Cancer=Rak
Smoke=Dym
Alchemist=Alchemik
Gold=Złoto
Radioactivity=Radioaktywność
Uranium=Uran
Plutonium=Pluton
Atomicbomb=Bomba atomowa
Hydrogenbomb=Bomba wodorowa
Alien=Obcy
Starship=Statek kosmiczny
CaptainPicard=Kapitan Picard
USSEnterprise=USS Enterprise
Supernova=Supernowa
Blackhole=Czarna dziura
Wormhole=Tunel czasoprzestrzenny
Void=Próżnia
BigBang=Wielki wybuch
BigCrunch=Wielki kryzys
Idea=Pomysł
StephenHawking=Stephen Hawking
AlbertEinstein=Albert Einstein
Relativitytheory=Teoria względności
Lamp=Lampa
Lavalamp=Lampa lava
Genie=Dżinn
Prisoner=Więzień
Coral=Koral
VWBeetle=Volkswagen Garbus
Toast=Tost
Explosion=Eksplozja
OneUP=Dodatkowe życie
Mario=Mario
Yoshi=Yoshi
Yoshiegg=Jajko Yoshi
Team=Zespół
Boomushroom=Grzyb Boo
Computergame=Gra komputerowa
Luigi=Luigi
King=Król
Leach=Pijawka
LichKing=Król Lisz
Warcraft=Warcraft
Fireelemental=Żywioł ognia
Ant=Mrówka
Termite=Termit
Insects=Owady
Mosquito=Komar
Mantis=Modliszka
Infestation=Plaga
Robot=Robot
Zerg=Zerg
Protoss=Protoss
Terran=Terranie
Starcraft=StarCraft
QueenofBlades=Królowa ostrzy
Zeratul=Zeratul
JimRaynor=Jim Raynor
NeedforSpeed=Need for Speed
ResidentEvil=Resident Evil
TombRaider=Tomb Raider
LaraCroft=Lara Croft
Paint=Farba
Fabergeegg=Jajko carskie
Easteregg=Pisanka
Lighthouse=Latarnia morska
Frog=Żaba
Salamander=Salamandra
Diet=Dieta
Obesity=Otyłość
Rust=Rdza
Phoenix=Feniks
Sniper=Snajper
Sushi=Sushi
Vulture=Sęp
Weevil=Wołek zbożowy
Undead=Nieumarły
Vinegar=Ocet
Spinningwheel=Kołowrotek
Yarn=Przędza
Aluminium=Glin
Kangaroo=Kangur
Russia=Rosja
Romania=Rumunia
USA=Stany Zjednoczone
France=Francja
Germany=Niemcy
UK=Wielka Brytania
China=Chiny
Egypt=Egipt
Italy=Włochy
SouthAfrica=RPA
Mexico=Meksyk
India=Indie
Japan=Japonia
Iceland=Islandia
Switzerland=Szwajcaria
Australia=Australia
Dracula=Drakula
Somalia=Somalia
SaudiArabia=Arabia Saudyjska
Napoleon=Napoleon
Antarctica=Antarktyda
Brazil=Brazylia
Canada=Kanada
Norway=Norwegia
KarelCapek=Karel Čapek
CzechRepublic=Czechy
Sauna=Sauna
Finland=Finlandia
Netherlands=Holandia
Alcoholic=Alkoholik
Ashtray=Popielniczka
Tropics=Tropiki
SugarCane=Trzcina cukrowa
Sugar=Cukier
Caramel=Karmel
Clock=Zegar
Firefighter=Strażak
Firefly=Świetlik
Juice=Sok
LightningRod=Instalacja odgromowa
Mirror=Lustro
Peat=Torf
SwissArmyKnife=Szwajcarski nóż oficerski
ScotchWhiskey=Szkocka
Scotland=Szkocja
Samurai=Samuraj
Rubber=Guma
Ball=Piłka
Football=Piłka nożna
StarWars=Gwiezdne wojny
R2D2=R2-D2
C3PO=C-3PO
Lobster=Homar
Camel=Wielbłąd
Statue=Posąg
Monument=Pomnik
LibertyStatue=Statua wolności
EiffelTower=Wieża Eiffla
Colosseum=Koloseum
BigBen=Big Ben
TajMahal=Tadź Mahal
Playcards=Karty
Jellyfish=Meduza
Ambulance=Ambulans
Sound=Dźwięk
Music=Muzyka
Guitar=Gitara
GuitarHero=Guitar Hero
Sport=Sport
F1=Formuła 1
Gymnastics=Gimnastyka
TableTennis=Tenis stołowy
AmericanFootball=Futbol amerykański
Hockey=Hokej
Rugby=Rugby
Ferrari=Ferrari
Ford=Ford
Mercedes=Mercedes
Audi=Audi
BWM=BMW
Renault=Renault
Nissan=Nissan
Toyota=Toyota
Cricket=Krykiet
ManUtd=Manchester United
Chelsea=Chelsea Londyn
Arsenal=Arsenał
Liverpool=Liverpool F.C.
Picture=Zdjęcie
Camera=Aparat
Movie=Film
Theater=Teatr
Oscar=Oskar
Linux=Linux
Artist=Artysta
Hail=Grad
Airport=Lotnisko
Geek=Maniak
Nerd=Frajer
Blowfish=Rozdymka
Musician=Muzyk
Astronaut=Astronauta
Science=Nauka
Chemistry=Chemia
Biology=Biologia
Physics=Fizyka
Geology=Geologia
Paleontology=Paleontologia
Astronomy=Astronomia
CharlesDarwin=Karol Darwin
MobyDick=Moby Dick
Chalk=Kreda
Blackboard=Tablica
Student=Student
School=Szkoła
Schoolbus=Autobus szkolny
Soundofmusic=Dźwięk muzyki
Money=Pieniądze
Economy=Gospodarka
Economics=Ekonomia
Dollar=Dolar
Euro=Euro
Pound=Funt
Europe=Europa
Bank=Bank
Vault=Skarbiec
Plastic=Plastik
Creditcard=Karta kredytowa
Box=Pudło
Container=Kontener
Cargo=Ładunek
Safe=Sejf
Depositbox=Skrytka bankowa
Toolbox=Skrzynka narzędziowa
Basket=Kosz
Basketball=Koszykówka
Helmet=Kask
Work=Praca
Worker=Pracownik
Company=Firma
Factory=Fabryka
Product=Produkt
Christmas=Boże Narodzenie
Gift=Prezent
Giftbox=Pudełko
Soundmixer=Stół mikserski
Speakers=Głośniki
Language=Język
Linguistics=Językoznawstwo