Fire=Fogo
Water=Água
Air=Ar
Earth=Terra
Ocean=Oceano
Lava=Lava
Volcano=Vulcão
Pressure=Pressão
Ash=Cinzas
Stone=Pedra
Metal=Metal
Wind=Vento
Swamp=Pântano
Energy=Energia
Life=Vida
Algae=Algas
Bacteria=Bactéria
Worm=Verme
Sulfur=Enxofre
Ghost=Fantasma
Steam=Vapor
Sand=Areia
Dust=Poeira
Gunpowder=Pólvora
Mud=Lama
Mite=Ácaro
Seed=Semente
Clay=Argila
Glass=Vidro
Snake=Serpente
Beach=Praia
Desert=Deserto
Silicon=Silício
Hourglass=Ampulheta
Tree=Árvore
Egg=Ovo
Lizard=Lagarto
Beast=Besta
Monkey=Macaco
Man=Homem
Grove=Pomar
Forest=Floresta
Tool=Ferramenta
Livestock=Gado
Bear=Urso
Panda=Panda
Shark=Tubarão
Bird=Pássaro
Omelette=Omelete
Turtle=Tartaruga
Tortoise=Jabuti
Fish=Peixe
Caviar=Caviar
Dinosaur=Dinossauro
Chicken=Galinha
Transistor=Transistor
Chip=Chip
Computer=Computador
Radio=Rádio
Radar=Radar
Ice=Gelo
PolarBear=Urso Polar
Hippopotamus=Hipopótamo
Tornado=Tornado
Storm=Tempestade
Cloud=Nuvem
Sky=Céu
Rain=Chuva
Thunderstorm=Trovoada
Snow=Neve
Electricity=Eletricidade
Lightbulb=Lâmpada
Light=Luz
Rainbow=Arco-Íris
Sun=Sol
Penguin=Pinguim
Brick=Tijolo
Beetle=Besouro
Mushroom=Cogumelo
Flower=Flor
Fruit=Fruta
Watermelon=Melancia
Moon=Lua
Planet=Planeta
Solarsystem=Sistema Solar
Galaxy=Galáxia
Universe=Universo
Butterfly=Borboleta
Fly=Mosca
Dragonfly=Libélula
Plesiosaur=Plesiossauro
Pterosaur=Pterossauro
Dragon=Dragão
Tiger=Tigre
Star=Estrela
Starfish=Estrela-do-mar
Arm=Armas
Lightsaber=Sabre de Luz
Firearm=Arma de fogo
Hunter=Caçador
Warrior=Guerreiro
Soldier=Soldado
Cactus=Cacto
Fisherman=Pescador
Poison=Veneno
Lichen=Líquen
Corpse=Cadáver
Fugu=Baiacú
Assassin=Assassino
Sith=Sith
Jedi=Jedi
DarthVader=Darth Vader
Poisonedweapon=Arma Química
Plankton=Plâncton
Whale=Baleia
Shell=Concha
Limestone=Calcário
Pearl=Pérola
Snail=Caracol
Lime=Cal
Cement=Cimento
Concrete=Concreto
Mold=Bolor
Cheese=Queijo
Mouse=Rato
Cat=Gato
TomandJerry=Tom e Jerry
Fondue=Fondue
Moss=Musgo
Fern=Samambaia
Fossil=Fóssil
Grass=Grama
Milk=Leite
Manure=Estrume
Yogurt=Iogurte
Flu=Gripe
Ozone=Ozônio
Airplane=Avião
Arable=Lavoura
Geyser=Géiser
Wheat=Trigo
Flour=Farinha
Dough=Massa
Bread=Pão
Pizza=Pizza
Pie=Torta
Kerogen=Querogênio
Bitumen=Betume
Petroleum=Petróleo
Gasoline=Gasolina
Scorpion=Escorpião
Cochineal=Cochonilha
Carmine=Carmim
Scarab=Escaravelho
TheBeatles=The Beatles
Wheel=Roda
Bicycle=Bicicleta
Wagon=Carroça
Coal=Carvão
Uncutdiamond=Diamante Bruto
Diamond=Diamante
Boiler=Caldeira
Steamengine=Motor a vapor
Combustionengine=Motor a combustão
Locomotive=Locomotiva
Car=Carro
Motorcycle=Motocicleta
Motorboat=Lancha
Boat=Barco
Woodenship=Caravela
Steamer=Navio a vapor
Wood=Madeira
Coffin=Caixão
Pinocchio=Pinóquio
Grape=Uva
Yeast=Levedura
Alcohol=Álcool
Wine=Vinho
Beer=Cerveja
Tequila=Tequila
Vodka=Vodka
Perfume=Perfume
Paper=Papel
Book=Livro
Library=Biblioteca
Hut=Cabana
House=Casa
Skyscraper=Arranha-céu
City=Cidade
Country=País
Continent=Continente
Time=Tempo
Oldman=Idoso
Christmastree=Árvore de Natal
Santaclaus=Papai Noel
Snowman=Boneco de neve
Scientist=Cientista
Penicillin=Penicilina
Meat=Carne
Wool=Lã
Cloth=Pano
Clothing=Vestuário
Knife=Faca
Scissors=Tesoura
Hydrogen=Hidrogênio
Oxygen=Oxigênio
Carbondioxide=Gás Carbônico
Sodawater=Soda
CocaCola=Coca-Cola
Barbeque=Churrasco
Mummy=Múmia
Pyramid=Pirâmide
Anubis=Anubis
Pharaoh=Faraó
Zombie=Zumbi
Frankenstein=Frankenstein
Grave=Sepultura
Cemetery=Cemitério
Blood=Sangue
Sailboat=Veleiro
Sick=Doente
Hospital=Hospital
Museum=Museu
Bar=Bar
Zoo=Zoológico
Feather=Pena
Pillow=Travesseiro
Quetzalcoatl=Quetzalcoatl
Bat=Morcego
Batman=Batman
Vampire=Vampiro
Werewolf=Lobisomem
TwilightSaga=Saga Crepúsculo
Sex=Sexo
SexandtheCity=Sex and the City
Kamasutra=Kamasutra
Chariot=Biga
Berry=Morango
Hencoop=Galinheiro
Avianflu=Gripe Aviária
Pig=Porco
Swineflu=Gripe suína
Bacon=Bacon
Soap=Sabão
Jungle=Selva
JungleBook=Mogli O menino lobo
Hero=Herói
RobinHood=Robin Hood
Submarine=Submarino
CaptainNemo=Capitão Nemo
Island=Ilha
Fat=Gordura
Pilot=Piloto
Captain=Capitão
Pirate=Pirata
Pirateship=Navio pirata
Treasure=Tesouro
Love=Amor
Sandwich=Sanduíche
McDonalds=McDonalds
Bow=Arco
Dam=Barragem
Beaver=Castor
Champagne=Champanhe
Ceramics=Cerâmica
Ectoplasm=Ectoplasma
Reed=Capim
Tobacco=Tabaco
Cigarettes=Cigarros
Cancer=Câncer
Smoke=Fumaça
Alchemist=Alquimista
Gold=Ouro
Radioactivity=Radioatividade
Uranium=Urânio
Plutonium=Plutônio
Atomicbomb=Bomba Atômica
Hydrogenbomb=Bomba de Hidrogênio
Alien=Alienígena
Starship=Nave estelar
CaptainPicard=Capitão Picard
USSEnterprise=USS Enterprise
Supernova=Supernova
Blackhole=Buraco negro
Wormhole=Fenda espacial
Void=Vazio
BigBang=Big Bang
BigCrunch=Big Crunch
Idea=Idéia
StephenHawking=Stephen Hawking
AlbertEinstein=Albert Einstein
Relativitytheory=Teoria da Relatividade
Lamp=Luminária
Lavalamp=Lâmpada de lava
Genie=Gênio
Prisoner=Prisioneiro
Coral=Coral
VWBeetle=Fusca
Toast=Torrada
Explosion=Explosão
OneUP=OneUp
Mario=Mario
Yoshi=Yoshi
Yoshiegg=Ovo de Yoshi
Team=Equipe
Boomushroom=Cogumelo Boo
Computergame=Jogo de Computador
Luigi=Luigi
King=Rei
Leach=Sanguessuga
LichKing=Lich King
Warcraft=Warcraft
Fireelemental=Fogo elementar
Ant=Formiga
Termite=Cupim
Insects=Insetos
Mosquito=Mosquito
Mantis=Louva-a-deus
Infestation=Infestação
Robot=Robô
Zerg=Zerg
Protoss=Protoss
Terran=Terran
Starcraft=Starcraft
QueenofBlades=Queen of Blades
Zeratul=Zeratul
JimRaynor=Jim Raynor
NeedforSpeed=Need For Speed
ResidentEvil=Resident Evil
TombRaider=Tomb Raider
LaraCroft=Lara Croft
Paint=Tinta
Fabergeegg=Ovo Fabergé
Easteregg=Ovo de Páscoa
Lighthouse=Farol
Frog=Sapo
Salamander=Salamandra
Diet=Dieta
Obesity=Obesidade
Rust=Ferrugem
Phoenix=Fênix
Sniper=Atirador de Elite
Sushi=Sushi
Vulture=Abutre
Weevil=Caruncho
Undead=Morto-vivo
Vinegar=Vinagre
Spinningwheel=Roda de fiar
Yarn=Fio têxtil
Aluminium=Alumínio
Kangaroo=Canguru
Russia=Rússia
Romania=Romênia
USA=EUA
France=França
Germany=Alemanha
UK=Reino Unido
China=China
Egypt=Egito
Italy=Itália
SouthAfrica=África do Sul
Mexico=México
India=Índia
Japan=Japão
Iceland=Islândia
Switzerland=Suiça
Australia=Australia
Dracula=Drácula
Somalia=Somália
SaudiArabia=Arábia Saudita
Napoleon=Napoleão
Antarctica=Antártida
Brazil=Brasil
Canada=Canadá
Norway=Noruega
KarelCapek=Karel Čapek
CzechRepublic=República Checa
Sauna=Sauna
Finland=Finlândia
Netherlands=Holanda
Alcoholic=Alcoólatra
Ashtray=Cinzeiro
Tropics=Trópicos
SugarCane=Cana-de-açucar
Sugar=Açúcar
Caramel=Caramelo
Clock=Relógio
Firefighter=Bombeiro
Firefly=Vaga-lume
Juice=Suco
LightningRod=Para-raios
Mirror=Espelho
Peat=Turfa
SwissArmyKnife=Canivete suíço
ScotchWhiskey=Uísque escocês
Scotland=Escócia
Samurai=Samurai
Rubber=Borracha
Ball=Bola
Football=Futebol
StarWars=StarWars
R2D2=R2D2
C3PO=C3P0
Lobster=Lobster
Camel=Camelo
Statue=Estátua
Monument=Monumento
LibertyStatue=Estátua da Liberdade
EiffelTower=Torre Eiffel
Colosseum=Coliseu
BigBen=Big Ben
TajMahal=Taj Mahal
Playcards=Playcards
Jellyfish=Medusa
Ambulance=Ambulância
Sound=Som
Music=Música
Guitar=Guitarra
GuitarHero=Guitar hero
Sport=Esporte
F1=Fórmula 1
Gymnastics=Ginástica
TableTennis=Tênis de mesa
AmericanFootball=Futebol Americano
Hockey=Hóquei
Rugby=Rugby
Ferrari=Ferrari
Ford=Ford
Mercedes=Mercedes
Audi=Audi
BWM=BMW
Renault=Renault
Nissan=Nissan
Toyota=Toyota
Cricket=Cricket
ManUtd=Manchester United
Chelsea=Chelsea
Arsenal=Arsenal
Liverpool=Liverpool
Picture=Foto
Camera=Câmera
Movie=Filme
Theater=Teatro
Oscar=Oscar
Linux=Linux
Artist=Artista
Hail=Granizo
Airport=Aeroporto
Geek=Geek
Nerd=Nerd
Blowfish=Baiacu
Musician=Músico
Astronaut=Astronauta
Science=Ciência
Chemistry=Química
Biology=Biologia
Physics=Física
Geology=Geologia
Paleontology=Paleontologia
Astronomy=Astronomia
CharlesDarwin=Charles Darwin
MobyDick=Moby Dick
Chalk=Gipsum
Blackboard=Quadro Negro
Student=Estudante
School=Escola
Schoolbus=Ônibus escolar
Soundofmusic=A Noviça Rebelde
Money=Dinheiro
Economy=Sistema Econômico
Economics=Economia
Dollar=Dólar
Euro=Euro
Pound=Libra
Europe=Europa
Bank=Banco
Vault=Caixa-Forte
Plastic=Plástico
Creditcard=Cartão de crédito
Box=Caixa
Container=Contêiner
Cargo=Carga
Safe=Cofre
Depositbox=Caixa de depósito
Toolbox=Caixa de Ferramentas
Basket=Basquete
Basketball=Bola de basquete
Helmet=Capacete
Work=Trabalho
Worker=Trabalhador
Company=Companhia
Factory=Fábrica
Product=Produto
Christmas=Natal
Gift=Presente
Giftbox=Caixa de presente
Soundmixer=Mixer
Speakers=Caixas de som
Language=Idioma
Linguistics=Linguística