Fire=Foc
Water=Apa
Air=Aer
Earth=Pamant
Ocean=Ocean
Lava=Lava
Volcano=Vulcan
Pressure=Presiune
Ash=Cenusa
Stone=Piatra
Metal=Metal
Wind=Vant
Swamp=Mlastina
Energy=Energie
Life=Viata
Algae=Alge
Bacteria=Bacterii
Worm=Vierme
Sulfur=Sulf
Ghost=Fantoma
Steam=Abur
Sand=Nisip
Dust=Praf
Gunpowder=Praf de pusca
Mud=Namol
Mite=Purici
Seed=Samanta
Clay=Argila
Glass=Sticla
Snake=Sarpe
Beach=Plaja
Desert=Desert
Silicon=Silicon
Hourglass=Clepsidra
Tree=Copac
Egg=Ou
Lizard=Soparla
Beast=Animal salbatic
Monkey=Maimuta
Man=Om
Grove=Padurice
Forest=Padure
Tool=Unealta
Livestock=Turma
Bear=Urs
Panda=Panda
Shark=Rechin
Bird=Pasare
Omelette=Omleta
Turtle=Testoasa
Tortoise=Testoasa de uscat
Fish=Peste
Caviar=Caviar
Dinosaur=Dinozaur
Chicken=Gaina
Transistor=Tranzistor
Chip=Cip
Computer=Calculator
Radio=Radio
Radar=Radar
Ice=Gheata
PolarBear=Urs polar
Hippopotamus=Hipopotam
Tornado=Tornada
Storm=Furtuna
Cloud=Nor
Sky=Cer
Rain=Ploaie
Thunderstorm=Vijelie
Snow=Zapada
Electricity=Electricitate
Lightbulb=Bec
Light=Lumina
Rainbow=Curcubeu
Sun=Soare
Penguin=Pinguin
Brick=Caramida
Beetle=Gandac
Mushroom=Ciuperca
Flower=Floare
Fruit=Fruct
Watermelon=Lubenita
Moon=Luna
Planet=Planeta
Solarsystem=Sistem solar
Galaxy=Galaxie
Universe=Univers
Butterfly=Fluture
Fly=Musca
Dragonfly=Libelula
Plesiosaur=Plesiozaur
Pterosaur=Pterozaur
Dragon=Dragon
Tiger=Tigru
Star=Stea
Starfish=Stea de mare
Arm=Arma
Lightsaber=Sabie laser
Firearm=Arma de foc
Hunter=Vanator
Warrior=Razboinic
Soldier=Soldat
Cactus=Cactus
Fisherman=Pescar
Poison=Otrava
Lichen=Licheni
Corpse=Cadavru
Fugu=Fugu
Assassin=Asasin
Sith=Sith
Jedi=Jedi
DarthVader=Darth Vader
Poisonedweapon=Arma otravita
Plankton=Plancton
Whale=Balena
Shell=Scoica
Limestone=Calcar
Pearl=Perla
Snail=Melc
Lime=Var
Cement=Ciment
Concrete=Beton
Mold=Mucegai
Cheese=Cascaval
Mouse=Soarece
Cat=Pisica
TomandJerry=Tom si Jerry
Fondue=Fondue
Moss=Muschi
Fern=Feriga
Fossil=Fosila
Grass=Iarba
Milk=Lapte
Manure=Balega
Yogurt=Iaurt
Flu=Gripa
Ozone=Ozon
Airplane=Avion
Arable=Arabil
Geyser=Gheizer
Wheat=Grau
Flour=Faina
Dough=Aluat
Bread=Paine
Pizza=Pizza
Pie=Placinta
Kerogen=Cherogen
Bitumen=Bitum
Petroleum=Petrol
Gasoline=Benzina
Scorpion=Scorpion
Cochineal=Cochineal
Carmine=Colorant
Scarab=Scarabeu
TheBeatles=The Beatles
Wheel=Roata
Bicycle=Bicicleta
Wagon=Caruta
Coal=Carbune
Uncutdiamond=Diamant nefinisat
Diamond=Diamant
Boiler=Boiler
Steamengine=Motor cu aburi
Combustionengine=Motor pe combustie
Locomotive=Locomotiva
Car=Masina
Motorcycle=Motorcicleta
Motorboat=Barca cu motor
Boat=Barca
Woodenship=Corabie
Steamer=Vapor cu aburi
Wood=Lemn
Coffin=Sicriu
Pinocchio=Pinocchio
Grape=Strugure
Yeast=Drojdie
Alcohol=Alcool
Wine=Vin
Beer=Bere
Tequila=Tequila
Vodka=Vodka
Perfume=Parfum
Paper=Hartie
Book=Carte
Library=Biblioteca
Hut=Cocioaba
House=Casa
Skyscraper=Zgarie-nor
City=Oras
Country=Tara
Continent=Continent
Time=Timp
Oldman=Batran
Christmastree=Brad de Craciun
Santaclaus=Mos Craciun
Snowman=Om de zapada
Scientist=Om de stiinta
Penicillin=Penicilina
Meat=Carne
Wool=Lana
Cloth=Textila
Clothing=Haine
Knife=Cutin
Scissors=Foarfeca
Hydrogen=Hidrogen
Oxygen=Oxigen
Carbondioxide=CO2
Sodawater=Apa minerala
CocaCola=Coca Cola
Barbeque=Gratar
Mummy=Mumie
Pyramid=Piramida
Anubis=Anubis
Pharaoh=Faraon
Zombie=Zombie
Frankenstein=Frankenstein
Grave=Mormant
Cemetery=Cimitir
Blood=Sange
Sailboat=Barca cu panze
Sick=Bolnav
Hospital=Spital
Museum=Muzeu
Bar=Bar
Zoo=Zoo
Feather=Pana
Pillow=Perina
Quetzalcoatl=Quetzalcoatl
Bat=Liliac
Batman=Batman
Vampire=Vampir
Werewolf=Varcolac
TwilightSaga=Saga Twilight
Sex=Sex
SexandtheCity=Sex and the City
Kamasutra=Kamasutra
Chariot=Car
Berry=Bobite
Hencoop=Cotet de gaini
Avianflu=Gripa aviara
Pig=Porc
Swineflu=Gripa porcina
Bacon=Sunca
Soap=Sapun
Jungle=Jungla
JungleBook=Cartea junglei
Hero=Erou
RobinHood=Robin Hood
Submarine=Submarin
CaptainNemo=Capitanul Nemo
Island=Insula
Fat=Grasime
Pilot=Pilot
Captain=Capitan
Pirate=Pirat
Pirateship=Corabie de pirati
Treasure=Comoara
Love=Dragoste
Sandwich=Sandvici
McDonalds=McDonalds
Bow=Arc
Dam=Baraj
Beaver=Castor
Champagne=Sampanie
Ceramics=Ceramica
Ectoplasm=Ectoplasma
Reed=Stuf
Tobacco=Tutun
Cigarettes=Tigari
Cancer=Cancer
Smoke=Fum
Alchemist=Alchimist
Gold=Aur
Radioactivity=Radioactivitate
Uranium=Uraniu
Plutonium=Plutoniu
Atomicbomb=Bomba atomic
Hydrogenbomb=Bomba cu hidrogen
Alien=Extraterestru
Starship=Nava spatiala
CaptainPicard=Capitanul Picard
USSEnterprise=USS Enterprise
Supernova=Supernova
Blackhole=Gaura neagra
Wormhole=Gaura de vierme
Void=Vid
BigBang=Big Bang
BigCrunch=Big Crunch
Idea=Idee
StephenHawking=Stephen Hawking
AlbertEinstein=Albert Einstein
Relativitytheory=Teoria relativitatii
Lamp=Lampa
Lavalamp=Lampa cu lava
Genie=Spirit de lampa
Prisoner=Prisonier
Coral=Coral
VWBeetle=VW Beetle
Toast=Paine prajita
Explosion=Explozie
OneUP=1UP
Mario=Mario
Yoshi=Yoshi
Yoshiegg=Ou Yoshi
Team=Echipa
Boomushroom=Ciuperca Boo
Computergame=Joc pe computer
Luigi=Luigi
King=Rege
Leach=Lipitoare
LichKing=Lich King
Warcraft=Warcraft
Fireelemental=Fire elemental
Ant=Furnica
Termite=Termita
Insects=Insecte
Mosquito=Tantar
Mantis=Mantisa
Infestation=Infestare
Robot=Robot
Zerg=Zerg
Protoss=Protoss
Terran=Terran
Starcraft=Starcraft
QueenofBlades=Queen of Blades
Zeratul=Zeratul
JimRaynor=Jim Raynor
NeedforSpeed=Need for Speed
ResidentEvil=Resident Evil
TombRaider=Tomb Raider
LaraCroft=Lara Croft
Paint=Vopsea
Fabergeegg=Ou Faberge
Easteregg=Ou de Paste
Lighthouse=Far
Frog=Broasca
Salamander=Salamandra
Diet=Dieta
Obesity=Obezitate
Rust=Rugina
Phoenix=Phoenix
Sniper=Lunetist
Sushi=Sushi
Vulture=Vultur
Weevil=Gargarita
Undead=Mort viu
Vinegar=Otet
Spinningwheel=Tazboi de tesut
Yarn=Ace de impletit
Aluminium=Aluminiu
Kangaroo=Kangaroo
Russia=Rusia
Romania=Romania
USA=SUA
France=Franta
Germany=Germania
UK=Marea Britanie
China=China
Egypt=Egipt
Italy=Italia
SouthAfrica=Africa de Sud
Mexico=Mexic
India=India
Japan=Japonia
Iceland=Islanda
Switzerland=Elvetia
Australia=Australia
Dracula=Dracula
Somalia=Somalia
SaudiArabia=Arabia Saudita
Napoleon=Napoleon
Antarctica=Antarctica
Brazil=Brazilia
Canada=Canada
Norway=Norvegia
KarelCapek=Karel Čapek
CzechRepublic=Cehia
Sauna=Sauna
Finland=Finlanda
Netherlands=Olanda
Alcoholic=Alcolic
Ashtray=Scrumiera
Tropics=Tropice
SugarCane=Trestie de zahar
Sugar=Zahar
Caramel=Caramel
Clock=Ceas
Firefighter=Pompier
Firefly=Licurici
Juice=Suc
LightningRod=Paratraznet
Mirror=Oglinda
Peat=Turba
SwissArmyKnife=Briceag
ScotchWhiskey=Whiskey
Scotland=Scotia
Samurai=Samurai
Rubber=Cauciuc
Ball=Minge
Football=Fotbal
StarWars=Razboiul stelelor
R2D2=R2D2
C3PO=C3P0
Lobster=Homar
Camel=Camila
Statue=Statuie
Monument=Monument
LibertyStatue=Statuia Libertatii
EiffelTower=Turnul Eiffel
Colosseum=Coloseumul
BigBen=Big Ben
TajMahal=Taj Mahal
Playcards=Carti de joc
Jellyfish=Meduza
Ambulance=Ambulanta
Sound=Sunet
Music=Muzica
Guitar=Chitara
GuitarHero=Chitarist faimos
Sport=Sport
F1=Formula 1
Gymnastics=Gimnastica
TableTennis=Tenis de masa
AmericanFootball=Fotbal american
Hockey=Hochei
Rugby=Rugby
Ferrari=Ferrari
Ford=Ford
Mercedes=Mercedes
Audi=Audi
BWM=BMW
Renault=Renault
Nissan=Nissan
Toyota=Toyota
Cricket=Cricket
ManUtd=Manchester United
Chelsea=Chelsea
Arsenal=Arsenal
Liverpool=Liverpool
Picture=Imagine
Camera=Aparat foto
Movie=Film
Theater=Teatru
Oscar=Oscar
Linux=Linux
Artist=Artist
Hail=Grindina
Airport=Aeroport
Geek=Geek
Nerd=Tocilar
Blowfish=Blowfish
Musician=Muzician
Astronaut=Astronaut
Science=Stiinta
Chemistry=Chimie
Biology=Biologie
Physics=Fizica
Geology=Geologie
Paleontology=Paleontologie
Astronomy=Astronomie
CharlesDarwin=Charles Darwin
MobyDick=Moby Dick
Chalk=Creta
Blackboard=Tabla
Student=Student
School=Scoala
Schoolbus=Autobuzul scolii
Soundofmusic=Sunetul muzicii
Money=Bani
Economy=Economie
Economics=Economie (stiinta)
Dollar=Dolar
Euro=Euro
Pound=Lira sterlina
Europe=Europa
Bank=Banca
Vault=Seif bancar
Plastic=Plastic
Creditcard=Carte de credit
Box=Cutie
Container=Container
Cargo=Cargo
Safe=Seif
Depositbox=Cutie de valori
Toolbox=Cutie de unelte
Basket=Cos
Basketball=Baschet
Helmet=Coif
Work=Munca
Worker=Muncitor
Company=Company
Factory=Fabrica
Product=Produs
Christmas=Craciun
Gift=Cadou
Giftbox=Cutie de cadouri
Soundmixer=Mixer audio
Speakers=Boxe
Language=Limba
Linguistics=Lingvistica