Fire=Oheň
Water=Voda
Air=Vzduch	
Earth=Zem
Ocean=Oceán
Lava=Láva
Volcano=Sopka
Pressure=Tlak
Ash=Popol
Stone=Kameň
Metal=Kov
Wind=Vietor
Swamp=Bažina
Energy=Energia
Life=Život
Algae=Riasa
Bacteria=Baktéria
Worm=Červ
Sulfur=Síra
Ghost=Duch
Steam=Para
Sand=Piesok
Dust=Prach
Gunpowder=Strelný prach
Mud=Bahno
Mite=Roztoč
Seed=Semeno
Clay=Hlina
Glass=Sklo
Snake=Had
Beach=Pláž
Desert=Púšť
Silicon=Silikón
Hourglass=Presýpacie hodiny
Tree=Strom
Egg=Vajce
Lizard=Plaz
Beast=Zviera
Monkey=Opica
Man=Človek
Grove=Háj
Forest=Les
Tool=Náradie
Livestock=Dobytok
Bear=Medveď
Panda=Panda
Shark=Žralok
Bird=Vták
Omelette=Omeleta
Turtle=Korytnačka
Tortoise=Vodná korytnačka
Fish=Ryba
Caviar=Kaviár
Dinosaur=Dinosaurus
Chicken=Kura
Transistor=Tranzistor
Chip=Čip
Computer=Počítač
Radio=Rádio
Radar=Radar
Ice=Ľad
PolarBear=Ľadový medveď
Hippopotamus=Hroch
Tornado=Tornádo
Storm=Búrka
Cloud=Oblak
Sky=Obloha
Rain=Dážď
Thunderstorm=Hromobitie
Snow=Sneh
Electricity=Elektrina
Lightbulb=Žiarovka
Light=Svetlo
Rainbow=Dúha
Sun=Slnko
Penguin=Tučniak
Brick=Tehla
Beetle=Chrobák
Mushroom=Hríb
Flower=Kvetina
Fruit=Ovocie
Watermelon=Melón
Moon=Mesiac
Planet=Planéta
Solarsystem=Slnečná sústava
Galaxy=Galaxia
Universe=Vesmír
Butterfly=Motýľ
Fly=Mucha
Dragonfly=Vážka
Plesiosaur=Plesiosaurus
Pterosaur=Pterosaurus
Dragon=Drak
Tiger=Tiger
Star=Hviezda
Starfish=Hviezdica
Arm=Zbraň
Lightsaber=Svetelný meč
Firearm=Puška
Hunter=Lovec
Warrior=Bojovník
Soldier=Vojak
Cactus=Kaktus
Fisherman=Rybár
Poison=Jed
Lichen=Lišajník
Corpse=Mŕtvola
Fugu=Fugu
Assassin=Vrah
Sith=Sith
Jedi=Jedi
DarthVader=Darth Vader
Poisonedweapon=Jedovatá zbraň
Plankton=Planktón
Whale=Veľryba
Shell=Mušľa
Limestone=Vápenec
Pearl=Perla
Snail=Slimák
Lime=Vápno
Cement=Cement
Concrete=Betón
Mold=Plieseň
Cheese=Syr
Mouse=Myš
Cat=Mačka
TomandJerry=Tom a Jerry
Fondue=Fondue
Moss=Mach
Fern=Papraď
Fossil=Skamenelina
Grass=Tráva
Milk=Mlieko
Manure=Hnoj
Yogurt=Jogurt
Flu=Chrípka
Ozone=Ozón
Airplane=Lietadlo
Arable=Ornica
Geyser=Gejzír
Wheat=Obilie
Flour=Múka
Dough=Cesto
Bread=Chlieb
Pizza=Pizza
Pie=Koláč
Kerogen=Kerogén
Bitumen=Bitúmen
Petroleum=Ropa
Gasoline=Benzín
Scorpion=Škorpión
Cochineal=Cochineal
Carmine=Karmín
Scarab=Scarab
TheBeatles=The Beatles
Wheel=Koleso
Bicycle=Bicykel
Wagon=Vagón
Coal=Uhlie
Uncutdiamond=Surový diamant
Diamond=Diamant
Boiler=Kotol
Steamengine=Parný stroj
Combustionengine=Spaľovací motor
Locomotive=Lokomotíva
Car=Auto
Motorcycle=Motocykel
Motorboat=Motorový čln
Boat=Loď
Woodenship=Drevená loď
Steamer=Parník
Wood=Drevo
Coffin=Rakva
Pinocchio=Pinocchio
Grape=Hrozno
Yeast=Kvasinka
Alcohol=Alkohol
Wine=Víno
Beer=Pivo
Tequila=Tequila
Vodka=Vodka
Perfume=Parfém
Paper=Papier
Book=Kniha
Library=Knižnica
Hut=Chata
House=Dom
Skyscraper=Mrakodrap
City=Mesto
Country=Štát
Continent=Kontinent
Time=Čas
Oldman=Starec
Christmastree=Vianočný stromček
Santaclaus=Santa klaus
Snowman=Snehuliak
Scientist=Vedec
Penicillin=Penicilín
Meat=Mäso
Wool=Vlna
Cloth=Plátno
Clothing=Oblečenie
Knife=Nôž
Scissors=Nožnice
Hydrogen=Vodík
Oxygen=Kyslík
Carbondioxide=Oxid uhličitý
Sodawater=Sóda
CocaCola=Coca Cola
Barbeque=Grilovanie
Mummy=Múmia
Pyramid=Pyramída
Anubis=Anubis
Pharaoh=Faraón
Zombie=Zombie
Frankenstein=Frankenstein
Grave=Hrob
Cemetery=Cintorín
Blood=Krv
Sailboat=Plachetnica
Sick=Choroba
Hospital=Nemocnica
Museum=Múzeum
Bar=Bar
Zoo=Zoo
Feather=Perie
Pillow=Poduška
Quetzalcoatl=Quetzalcoatl
Bat=Netopier
Batman=Batman
Vampire=Upír
Werewolf=Vlkodlak
TwilightSaga=Twilight
Sex=Sex
SexandtheCity=Sex v meste
Kamasutra=Kamasutra
Chariot=Dvojkolesový voz
Berry=Bobuľa
Hencoop=Kurník
Avianflu=Vtáčia chrípka
Pig=Prasa
Swineflu=Prasacia chrípka
Bacon=Slanina
Soap=Mydlo
Jungle=Džungľa
JungleBook=Kniha džunglí
Hero=Hrdina
RobinHood=Robin Hood
Submarine=Ponorka
CaptainNemo=Kapitán Nemo
Island=Ostrov
Fat=Tuk
Pilot=Pilot
Captain=Kapitán
Pirate=Pirát
Pirateship=Pirátska loď
Treasure=Poklad
Love=Láska
Sandwich=Sendvič
McDonalds=McDonalds
Bow=Luk
Dam=Priehrada
Beaver=Bobor
Champagne=Šampanské
Ceramics=Keramika
Ectoplasm=Ektoplazma
Reed=Trstina
Tobacco=Tabak
Cigarettes=Cigarety
Cancer=Rakovina
Smoke=Dym
Alchemist=Alchymista
Gold=Zlato
Radioactivity=Rádioaktivita
Uranium=Urán
Plutonium=Plutónium
Atomicbomb=Atómová bomba
Hydrogenbomb=Vodíková bomba
Alien=Mimozemšťan
Starship=Vesmírna loď
CaptainPicard=Kapitán Picard
USSEnterprise=USS Enterprise
Supernova=Supernova
Blackhole=Čierna diera
Wormhole=Červia diera
Void=Prázdnota
BigBang=Veľký tresk
BigCrunch=Veľký kolaps
Idea=Nápad
StephenHawking=Stephen Hawking
AlbertEinstein=Albert Einstein
Relativitytheory=Teória Relativity 
Lamp=Lampa
Lavalamp=Lávová lampa
Genie=Džin
Prisoner=Vezeň
Coral=Koral
VWBeetle=VW Chrobák
Toast=Toast
Explosion=Explózia
OneUP=1UP
Mario=Mario
Yoshi=Yoshi
Yoshiegg=Yoshiho vajce
Team=Tím
Boomushroom=Hríb Boo
Computergame=Počítačová hra
Luigi=Luigi
King=Kráľ
Leach=Pijavica
LichKing=Lich King
Warcraft=Warcraft
Fireelemental=Ohnivý elementál
Ant=Mravec
Termite=Termit
Insects=Hmyz
Mosquito=Moskyt
Mantis=Modlivka
Infestation=Zamorenie
Robot=Robot
Zerg=Zerg
Protoss=Protoss
Terran=Terran
Starcraft=Starcraft
QueenofBlades=Queen of Blades
Zeratul=Zeratul
JimRaynor=Jim Raynor
NeedforSpeed=Need for Speed
ResidentEvil=Resident Evil
TombRaider=Tomb Raider
LaraCroft=Lara Croft
Paint=Farba
Fabergeegg=Faborgské vajce
Easteregg=Veľkonočné vajce
Lighthouse=Maják
Frog=Žaba
Salamander=Salamandra
Diet=Diéta
Obesity=Obezita
Rust=Hrdza
Phoenix=Fénix
Sniper=Ostrelovač
Sushi=Suši
Vulture=Sup
Weevil=Nosatec
Undead=Nemrtvý
Vinegar=Ocot
Spinningwheel=Kolovrátok
Yarn=Priadza
Aluminium=Hliník
Kangaroo=Klokan
Russia=Rusko
Romania=Rumunsko
USA=USA
France=Francúzsko
Germany=Nemecko
UK=Anglicko
China=Čína
Egypt=Egypt
Italy=Taliansko
SouthAfrica=Juhoafrická republika
Mexico=Mexiko
India=India
Japan=Japonsko
Iceland=Island
Switzerland=Švajčiarsko
Australia=Austrália
Dracula=Drakula
Somalia=Somálsko
SaudiArabia=Saudská Arábia
Napoleon=Napoleon
Antarctica=Antarktída
Brazil=Brazília
Canada=Kanada
Norway=Nórsko
KarelCapek=Karel Čapek
CzechRepublic=Česká Republika
Sauna=Sauna
Finland=Fínsko
Netherlands=Holandsko
Alcoholic=Alkoholik
Ashtray=Popolník
Tropics=Trópy
SugarCane=Cukrová trstina
Sugar=Cukor
Caramel=Karamel
Clock=Hodiny
Firefighter=Požiarnik
Firefly=Svätojánska muška
Juice=Džús
LightningRod=Hromozvod
Mirror=Zrkadlo
Peat=Rašelina
SwissArmyKnife=Švajčiarky nožík
ScotchWhiskey=Škótska whiskey
Scotland=Škótsko
Samurai=Samuraj
Rubber=Guma
Ball=Lopta
Football=Futbal
StarWars=StarWars
R2D2=R2D2
C3PO=C3P0
Lobster=Homár
Camel=Ťava
Statue=Socha
Monument=Monument
LibertyStatue=Socha Slodoby
EiffelTower=Eiffelovka
Colosseum=Koloseum
BigBen=Big Ben
TajMahal=Taj Mahal
Playcards=Hracie karty
Jellyfish=Medúza
Ambulance=Sanitka
Sound=Zvuk
Music=Hudba
Guitar=Gitara
GuitarHero=Guitar hero
Sport=Šport
F1=Formula 1
Gymnastics=Gymnastika
TableTennis=Pingpong
AmericanFootball=Americký futbal
Hockey=Hokej
Rugby=Rugby
Ferrari=Ferrari
Ford=Ford
Mercedes=Mercedes
Audi=Audi
BWM=BMW
Renault=Renault
Nissan=Nissan
Toyota=Toyota
Cricket=Kriket
ManUtd=Manchester United
Chelsea=Chelsea
Arsenal=Arsenal
Liverpool=Liverpool
Picture=Obrázok
Camera=Kamera
Movie=Film
Theater=Divadlo
Oscar=Oscar
Linux=Linux
Artist=Umelec
Hail=Krúpy
Airport=Letisko
Geek=Geek
Nerd=Nerd
Blowfish=Fugu
Musician=Muzikant
Astronaut=Astronaut
Science=Veda
Chemistry=Chémia
Biology=Biológia
Physics=Fyzika
Geology=Geológia
Paleontology=Paleontológia
Astronomy=Astronómia
CharlesDarwin=Charles Darwin
MobyDick=Moby Dick
Chalk=Krieda
Blackboard=Tabuľa
Student=Študent
School=Škola
Schoolbus=Školský autobus
Soundofmusic=Muzikál Sound of Music
Money=Peniaze
Economy=Ekonómia
Economics=Ekonomika
Dollar=Dolár
Euro=Euro
Pound=Libra
Europe=Európa
Bank=Banka
Vault=Cennosť
Plastic=Plast
Creditcard=Kreditná karta
Box=Krabica
Container=Kontajner
Cargo=Preprava
Safe=Trezor
Depositbox=Depozitová schránka
Toolbox=Krabica s náradím
Basket=Kôš
Basketball=Basketbal
Helmet=Helma
Work=Práca
Worker=Pracovník
Company=Firma
Factory=Továreň
Product=Produkt
Christmas=Vianoce
Gift=Darček
Giftbox=Darčekové balenie
Soundmixer=Mixážny pult
Speakers=Reproduktory
Language=Jazyk
Linguistics=Jazykoveda