Fire=Fuego
Water=Agua
Air=Aire
Earth=Tierra
Ocean=Océano
Lava=Lava
Volcano=Volcán
Pressure=Presión
Ash=Ceniza
Stone=Piedra
Metal=Metal
Wind=Viento
Swamp=Pantano
Energy=Energía
Life=Vida
Algae=Alga
Bacteria=Bacteria
Worm=Gusano
Sulfur=Azufre
Ghost=Fantasma
Steam=Vapor
Sand=Arena
Dust=Polvo
Gunpowder=Pólvora
Mud=Barro
Mite=Mito
Seed=Semilla
Clay=Arcilla
Glass=Vidrio
Snake=Serpiente
Beach=Playa
Desert=Desierto
Silicon=Silicio
Hourglass=Reloj de Arena
Tree=Árbol
Egg=Huevo
Lizard=Lagarto
Beast=Bestia
Monkey=Mono
Man=Hombre
Grove=Arboleda
Forest=Bosque
Tool=Herramienta
Livestock=Ganado
Bear=Oso
Panda=Panda
Shark=Tiburón
Bird=Pájaro
Omelette=Omelette
Turtle=Tortuga
Tortoise=Tortuga terrestre
Fish=Pez
Caviar=Caviar
Dinosaur=Dinosaurio
Chicken=Pollo
Transistor=Transistor
Chip=Chip
Computer=Computadora
Radio=Radio
Radar=Radar
Ice=Hielo
PolarBear=Oso polar
Hippopotamus=Hipopótamo
Tornado=Tornado
Storm=Tormenta
Cloud=Nube
Sky=Cielo
Rain=Lluvia
Thunderstorm=Tormenta eléctrica
Snow=Nieve
Electricity=Electricidad
Lightbulb=Foco
Light=Luz
Rainbow=Arcoiris
Sun=Sol
Penguin=Pinguino
Brick=Ladrillo
Beetle=Mariquita
Mushroom=Hongo
Flower=Flor
Fruit=Fruta
Watermelon=Sandía
Moon=Luna
Planet=Planeta
Solarsystem=Sistema Solar
Galaxy=Galaxia
Universe=Universo
Butterfly=Mariposa
Fly=Mosca
Dragonfly=Libélula
Plesiosaur=Plesiosaurio
Pterosaur=Pterosaurio
Dragon=Dragon
Tiger=Tigre
Star=Estrella
Starfish=Estrella marina
Arm=Arma
Lightsaber=Espada de luz
Firearm=Arma de fuego
Hunter=Cazador
Warrior=Guerrero
Soldier=Soldado
Cactus=Cactus
Fisherman=Pescador
Poison=Veneno
Lichen=Liquen
Corpse=Cadáver
Fugu=Fugu
Assassin=Asesino
Sith=Sith
Jedi=Jedi
DarthVader=Darth Vader
Poisonedweapon=Arma envenenada
Plankton=Plancton
Whale=Ballena
Shell=Concha
Limestone=Piedra caliza
Pearl=Perla
Snail=Caracol
Lime=Lima
Cement=Cemento
Concrete=Concreto
Mold=Moho
Cheese=Queso
Mouse=Ratón
Cat=Gato
TomandJerry=Tom y Jerry
Fondue=Fondue
Moss=Musgo
Fern=Helecho
Fossil=Fósil
Grass=Pasto
Milk=Leche
Manure=Abono
Yogurt=Yogurt
Flu=Resfrío
Ozone=Ozono
Airplane=Avión
Arable=Arado
Geyser=Geyser
Wheat=Trigo
Flour=Harina
Dough=Masa
Bread=Pan
Pizza=Pizza
Pie=Pie
Kerogen=Querosén
Bitumen=Betún
Petroleum=Petróleo
Gasoline=Gasolina
Scorpion=Escorpión
Cochineal=Cochinilla
Carmine=Carmín
Scarab=Escarabajo
TheBeatles=Los Beatles
Wheel=Rueda
Bicycle=Bicicleta
Wagon=Carreta
Coal=Carbón
Uncutdiamond=Diamante en bruto
Diamond=Diamante
Boiler=Caldera
Steamengine=Máquina de vapor
Combustionengine=Motor de combustión
Locomotive=Locomotora
Car=Auto
Motorcycle=Motocicleta
Motorboat=Lancha a motor
Boat=Bote
Woodenship=Barco de madera
Steamer=Barco de vapor
Wood=Madera
Coffin=Cofre
Pinocchio=Pinocho
Grape=Uvas
Yeast=Levadura
Alcohol=Alcohol
Wine=Vino
Beer=Cerveza
Tequila=Tequila
Vodka=Vodka
Perfume=Perfume
Paper=Papel
Book=Libro
Library=Biblioteca
Hut=Choza
House=Casa
Skyscraper=Rascacielos
City=Ciudad
Country=País
Continent=Continente
Time=Tiempo
Oldman=Anciano
Christmastree=Árbol de Navidad
Santaclaus=Santa claus
Snowman=Hombre de nieve
Scientist=Científico
Penicillin=Penicilina
Meat=Carne
Wool=Cuero
Cloth=Tela
Clothing=Vestimenta
Knife=Cuchillo
Scissors=Tijeras
Hydrogen=Hidrógeno
Oxygen=Oxígeno
Carbondioxide=Dióxido de carbón
Sodawater=Gaseosa
CocaCola=Coca Cola
Barbeque=Churrasco
Mummy=Momia
Pyramid=Pirámide
Anubis=Anubis
Pharaoh=Faraón
Zombie=Zombie
Frankenstein=Frankenstein
Grave=Tumba
Cemetery=Cementerio
Blood=Sangre
Sailboat=Yate
Sick=Enfermo
Hospital=Hospital
Museum=Museo
Bar=Bar
Zoo=Zoo
Feather=Pluma
Pillow=Almohada
Quetzalcoatl=Quetzalcoatl
Bat=Murciélago
Batman=Batman
Vampire=Vampiro
Werewolf=Hombre lobo
TwilightSaga=Saga de Eclipse
Sex=Sexo
SexandtheCity=Sexo y la Ciudad
Kamasutra=Kamasutra
Chariot=Carroza
Berry=Baya
Hencoop=Gallinero
Avianflu=Gripe Aviar
Pig=Cerdo
Swineflu=Gripe Porcina
Bacon=Tocino
Soap=Jabón
Jungle=Selva
JungleBook=El libro de la Selva
Hero=Héroe
RobinHood=Robin Hood
Submarine=Submarino
CaptainNemo=Capitán Nemo
Island=Isla
Fat=Grasa
Pilot=Piloto
Captain=Capitán
Pirate=Pirata
Pirateship=Barco Pirata
Treasure=Tesoro
Love=Amor
Sandwich=Sandwich
McDonalds=McDonalds
Bow=Flecha
Dam=Represa
Beaver=Castor
Champagne=Champaña
Ceramics=Cerámica
Ectoplasm=Ectoplasma
Reed=Caña
Tobacco=Tabaco
Cigarettes=Cigarrillos
Cancer=Cáncer
Smoke=Humo
Alchemist=Alquimista
Gold=Oro
Radioactivity=Radioactividad
Uranium=Uranio
Plutonium=Plutonio
Atomicbomb=Bomba Atómica
Hydrogenbomb=Bomba H
Alien=Extraterrestre
Starship=Nave Galáctica
CaptainPicard=Capitán Picard
USSEnterprise=USS Enterprise
Supernova=Supernova
Blackhole=Agujero Negro
Wormhole=Agujero de gusano
Void=Vacío
BigBang=Gran Explosión
BigCrunch=Gran Implosión
Idea=Idea
StephenHawking=Stephen Hawking
AlbertEinstein=Albert Einstein
Relativitytheory=T. Relatividad
Lamp=Lámpara
Lavalamp=Lámpara de lava
Genie=Genio
Prisoner=Prisionero
Coral=Coral
VWBeetle=VW Beetle
Toast=Tostada
Explosion=Explosión
OneUP=1UP
Mario=Mario
Yoshi=Yoshi
Yoshiegg=Huevo de Yoshi
Team=Equipo
Boomushroom=Hongo Fantasma
Computergame=Videojuego
Luigi=Luigi
King=Rey
Leach=Sanguijuela
LichKing=Lich King
Warcraft=Warcraft
Fireelemental=Elemental de Fuego
Ant=Hormiga
Termite=Termita
Insects=Insectos
Mosquito=Mosquito
Mantis=Mantis
Infestation=Infestación
Robot=Robot
Zerg=Zerg
Protoss=Protoss
Terran=Terran
Starcraft=Starcraft
QueenofBlades=Kerrigan
Zeratul=Zeratul
JimRaynor=Jim Raynor
NeedforSpeed=Need for Speed
ResidentEvil=Resident Evil
TombRaider=Tomb Raider
LaraCroft=Lara Croft
Paint=Pintura
Fabergeegg=Huevo Fabergé
Easteregg=Huevo de Pascua
Lighthouse=Faro
Frog=Rana
Salamander=Salamandra
Diet=Dieta
Obesity=Obesidad
Rust=Óxido
Phoenix=Fénix
Sniper=Francotirador
Sushi=Sushi
Vulture=Buitre
Weevil=Gorgojo
Undead=Muerto viviente
Vinegar=Vinagre
Spinningwheel=Rueca
Yarn=Hilado
Aluminium=Aluminio
Kangaroo=Canguro
Russia=Rusia
Romania=Rumania
USA=Estados Unidos
France=Francia
Germany=Alemania
UK=Reino Unido
China=China
Egypt=Egipto
Italy=Italia
SouthAfrica=Sud África
Mexico=México
India=India
Japan=Japón
Iceland=Islandia
Switzerland=Suiza
Australia=Australia
Dracula=Drácula
Somalia=Somalia
SaudiArabia=Arabia Saudita
Napoleon=Napoleón
Antarctica=Antártica
Brazil=Brasil
Canada=Canadá
Norway=Noruega
KarelCapek=Karel Čapek
CzechRepublic=República Checa
Sauna=Sauna
Finland=Finlandia
Netherlands=Holanda
Alcoholic=Alcohólico
Ashtray=Cenicero
Tropics=Trópico
SugarCane=Caña de azúcar
Sugar=Azúcar
Caramel=Caramelo
Clock=Reloj
Firefighter=Bombero
Firefly=Luciérnaga
Juice=Jugo
LightningRod=Pararrayos
Mirror=Espejo
Peat=Turba
SwissArmyKnife=Navaja Suiza
ScotchWhiskey=Whiskey Escocés
Scotland=Escocia
Samurai=Samurai
Rubber=Goma
Ball=Pelota
Football=Fútbol
StarWars=Star Wars
R2D2=R2D2
C3PO=C3P0
Lobster=Langosta
Camel=Camello
Statue=Estatua
Monument=Monumento
LibertyStatue=Estatua de la Libertad
EiffelTower=Torre Eiffel
Colosseum=Coliseo de Roma
BigBen=Big Ben
TajMahal=Taj Mahal
Playcards=Cartas de juego
Jellyfish=Medusa
Ambulance=Ambulancia
Sound=Sonido
Music=Música
Guitar=Guitarra
GuitarHero=Guitar Hero
Sport=Deporte
F1=Fórmula 1
Gymnastics=Gimnasia Olímpica
TableTennis=Ping pong
AmericanFootball=Fútbol americano
Hockey=Hockey
Rugby=Rugby
Ferrari=Ferrari
Ford=Ford
Mercedes=Mercedes
Audi=Audi
BWM=BMW
Renault=Renault
Nissan=Nissan
Toyota=Toyota
Cricket=Cricket
ManUtd=Manchester United
Chelsea=Chelsea
Arsenal=Arsenal
Liverpool=Liverpool
Picture=Imagen
Camera=Cámara
Movie=Cine
Theater=Teatro
Oscar=Óscar
Linux=Linux
Artist=Artista
Hail=Granizo
Airport=Aeropuerto
Geek=Geek
Nerd=Nerd
Blowfish=Pez Globo
Musician=Músico
Astronaut=Astronauta
Science=Ciencia
Chemistry=Química
Biology=Biología
Physics=Física
Geology=Geología
Paleontology=Paleontología
Astronomy=Astronomía
CharlesDarwin=Charles Darwin
MobyDick=Moby Dick
Chalk=Tiza
Blackboard=Pizarra
Student=Estudiante
School=Escuela
Schoolbus=Bus escolar
Soundofmusic=Sound of Music
Money=Dinero
Economy=Economía
Economics=Ciencias Económicas
Dollar=Dólar
Euro=Euro
Pound=Libra
Europe=Europa
Bank=Banco
Vault=Bóveda
Plastic=Plástico
Creditcard=Tarjeta de Crédito
Box=Caja
Container=Contenedor
Cargo=Encomienda
Safe=Caja Fuerte
Depositbox=Caja de depósito
Toolbox=Caja de Herramientas
Basket=Cesto
Basketball=Baloncesto
Helmet=Casco
Work=Trabajo
Worker=Trabajador
Company=Compañía
Factory=Fábrica
Product=Producto
Christmas=Navidad
Gift=Regalo
Giftbox=Caja de regalo
Soundmixer=Mezcladora de sonido
Speakers=Parlantes
Language=Lenguaje
Linguistics=Lingüística