NonTerminalsHint=Dostupné objevy {0}/{1}
NonTerminalsSearchHint=Vyhledejte element
TerminalsHint=Konečný element
ButtonHint=Rada
ButtonWiki=Wiki
ButtonMore=Více
ButtonHelp=Pomoc
ButtonAbout=O aplikaci
DesktopHint=Sem přetáhni element pro kombinaci
TrashHint=Sem přetáhni element pro odstranění
HelpTitle=Pomoc
HelpLine1=Začínáš se čtyřmi základními elementy: ohněm, vzduchem, vodou a zemí. Jejich kombinací získáč další elementy. Hra je u konce, pokud jsou objeveny všechny elementy.\n\n
HelpLine2=Můžeš přetáhnout elementy z levého panelu do centrální části (pracovní plochu). Přetahuj dva elementy na sebe a tím je kombinuj. Některé elementy jsou konečné. Takové již nelze kombinovat. jsou zobrazeny v druhém panelu a nelze je přetáhnout do střední části. Element lze také přidat dvouklikem na seznam elementů.\n\n
HelpLine3=Pro odstranění elementu z pracovní plochy jej přetáhněte na popelnici. Pro odstranění všech elementů z pracovní plochy dvouklikněte na popelnici. Elementy můžete vymazat také vybráním elementu myší spolu s klávesou CTRL a poté stisknutím klávesy Delete.\n\n
HelpLine4=Dvouklikněte na element z pracovní plochy pro jeho kopii. Kvouklikem na volné místo pracovní plochy budou přidány čtyři základní elementy. \n\n
AboutTitle=O Alchemy
AboutLine1=Alchemy {0} pro Windows\n
AboutLine2=Autor: Marius Bancila\n
AboutLine3=Copyright (c) 2010-2011 Marius Bancila\n
AboutLine4=Navštivte www.mariusbancila.ro\n
AboutLine5=Inspirováno Alchemy pro Android od Andrey Zaikin
CheatTitle=Zobrazit všechny dostupné elementy
HintTitle=Rada
HintDescription=Zkuste vytvořit
HintFrom=z
HintClose=Klikněte do plochy pro zavření okna
LanguageTitle=Jazyk
LanguageDescription=Zvolte jazyk
LanguageButton=Vybrat {0} jako nový jazyk
HeaderSaves=Uložené
HeaderLanguage=Jazyk
HeaderSettings=Nastavení
HeaderCheats=Cheats
HeaderCredits=Kredit
SavesInfoLine=Vaše hra je automaticky uložena při ukončení aplikace. Hra se znovu nahraje při startu aplikace.\n\nJe možné si hru uložit a znovu načíst z jiného než základního souboru.\n\nJe také možné hru zresetovat a začít znovu.\n
ButtonSave=Uložit
ButtonLoad=Nahrát
ButtonReset=Reset
SettingCombineNew=Kombinovat jen nové (ignoruj již vynalezené kombinace)
SettingTapCombine=Kombinuj kliknutím (nepřetahovat, kliknout na první, a pak druhý element)
MoreTitle=Více možností
ResetProgressWarning=Skutečně chcete aby se Váš současný pokrok zcela vymazal? Jste si jisti?\n\nJe doporučeno nejprve uložit aktuální stav, než provedete reset.\n\nSkutečně resetovat?
ShowTimer=Zobrazit časomíru (celkový uplynulý čas)
DesktopHint2=Klikni na Vymazat pro odstranění všech
DesktopHint3=Ctrl + kliknití + Delete pro vymazání elementu
DesktopHint4=Dvouklik na element pro jeho zdvojení
DesktopHint5=Dvouklik na plochu pro základní elementy
DesktopHint6=Použíj tlačítko Více pro nastavení
ElementsListHint1=Dvouklikem přidáte na plochu
ElementsListHint2=Chytni a přetáhni na plochu
ElementsListHint3=Některé elementy nelze kombinovat
ElementsListHint4=Zadej jménu pro filtrování seznamu
ButtonClear=Vymazat
VictoryTitle=Vítězství
VictoryCongrats=Gratuluji!
VictoryDescription=Vynalezl jsi všechny dostupné elementy!