NonTerminalsHint=Fundne elementer {0}/{1}
NonTerminalsSearchHint=Skriv her for at filtrere elementer
TerminalsHint=Slutelementer
ButtonHint=Hint
ButtonWiki=Wiki
ButtonMore=Mere
ButtonHelp=Hjælp
ButtonAbout=Om
DesktopHint=Træk elementer her for at kombinere
TrashHint=Træk elementer her for at slette
HelpTitle=Hjælp
HelpLine1=Du starter med fire basale elementer: ild, luft, vand og jord. Kombiner dem for at få nye elementer. Du er færdig når du finder alle elementerne.\n\n
HelpLine2=Du kan trække elementer fra det venstre panel ind i det centrale område. Træk to elementer sammen for at kombinere dem. Visse elementer er slutelementer, de kan ikke kombineres mere. De er vist i et andet panel og kan ikke trækkes ind på skrivebordsområdet. Du kan også tilføje elementer fra listen til skrivebordet ved at dobbeltklikke på dem.\n\n
HelpLine3=For at slette et element fra skrivebordet, træk det i skraldespanden. For at fjerne alle elementer fra skrivebordet, dobbeltklik på skraldespanden. Du kan også slette elementer ved at vælge dem med musen mens du holder Ctrl nede og derefter trykker Delete.\n\n
HelpLine4=Dobbeltklik på et element på skrivebordet for at fordoble det. Dobbeltklik på et tomt område af skrivebordet for at få de fire basale elementer.\n\n
AboutTitle=Om Alchemy
AboutLine1=Alchemy {0} til Windows\n
AboutLine2=Kreeret af Marius Bancila\n
AboutLine3=Copyright (c) 2010-2011 Marius Bancila\n
AboutLine4=Besøg på www.mariusbancila.ro\n
AboutLine5=Inspireret af Alchemy til Android af Andrey Zaikin
CheatTitle=Vis alle tilgængelige elementer
HintTitle=Hints
HintDescription=Trøv at lave
HintFrom=Fra
HintClose=Klik i hint vinduet for at lukke det
LanguageTitle=Sprog
LanguageDescription=Vælg sprog
LanguageButton=Vælg {0} som nyt sprog
HeaderSaves=Gemte
HeaderLanguage=Sprog
HeaderSettings=Indstillinger
HeaderCheats=Snyd
HeaderCredits=Credits
SavesInfoLine=Dit fremskridt i spillet bliver gemt automatisk når du lukker spillet og hentet når du åbner det.\n\nDu kan gemme eller hente fremskridt til eller fra andre filer end standarden.\n\nDu kan også nulstille dit fremskridt og starte helt forfra.\n
ButtonSave=Gem
ButtonLoad=Hent
ButtonReset=Start forfra
SettingCombineNew=Kombiner kun nye (ignorer allerede fundne kombinationer)
SettingTapCombine=Klik for at kombinere (ikke træk, klik på første element og derefter på andet)
MoreTitle=Flere indstillinger
ResetProgressWarning=Du er ved at slette hele dit fremskridt. Er du sikker på at du vil gøre det?\n\nDet anbefales at du gemmer dit fremskridt før du nulstiller.\n\nVil du nulstille?
ShowTimer=Vis ur (Totalt forløbet tid)
DesktopHint2=Klik her for at slette alt
DesktopHint3=Ctrl + museklik + Delete for at slette et element
DesktopHint4=Dobbeltklik på et element for at fordoble det
DesktopHint5=Dobbeltklik på desktoppen for de basale elementer
DesktopHint6=Brug knappen Mere for indstillinger
ElementsListHint1=Dobbeltklik for at tilføje til desktoppen
ElementsListHint2=Træk og slip til desktoppen
ElementsListHint3=Visse elementer kan ikke kombineres
ElementsListHint4=Skriv et navn for at filtrere listen
ButtonClear=Ryd
VictoryTitle=Sejr
VictoryCongrats=Lykønskninger!
VictoryDescription=Du har fundet alle tilgængelige elementer!