NonTerminalsHint=Gevonden elementen {0}/{1}
NonTerminalsSearchHint=Elementen filteren
TerminalsHint=Eind elementen
ButtonHint=Hint
ButtonWiki=Wiki
ButtonMore=Meer
ButtonHelp=Help
ButtonAbout=Over
DesktopHint=Elementen hierheen slepen om te combineren
TrashHint=Elementen hierheen slepen om te verwijderen
HelpTitle=Help
HelpLine1=Je start met vier basis elementen: vuur, lucht, water en aarde. Combineer ze om nieuwe elementen te verkrijgen. Je bent klaar als je alle elementen hebt gevonden.\n\n
HelpLine2=Gevonden elementen worden getoont op het middenscherm en op het linkerscherm. Om een gevonden element terug te krijgen op het middenscherm kan je deze simpel vanuit het linkerscherm slepen naar het middenscherm (of dubbelklikken). Sommige elementen zijn eind elementen en kunnen niet meer worden gecombineerd. Deze zijn te herkennen aan het rode stopteken op het element.Deze elementen zijn niet meer naar het midden te slepen. \n\n
HelpLine3=Om alle elementen van het middenscherm te verwijderen klik je op de wissen knop. Om één of meerdere elementen te wissen houd je de ctrl toets ingedrukt terwijl je klikt op de elementen die je van het middenscherm wil verwijderen. Klik vervolgens op de delete toets. .\n\n
HelpLine4=Dubbelklik op een element in het middenscherm om te kopieëren. Dubbelklik op een lege plaats van het middenscherm om de vier basiselementen te verkrijgen.\n\n
AboutTitle=Over Alchemy
AboutLine1=Alchemy {0} voor Windows\n
AboutLine2=Ontworpen by Marius Bancila\n
AboutLine3=Copyright (c) 2010-2011 Marius Bancila\n
AboutLine4=Bezoek mij op www.mariusbancila.ro\n
AboutLine5=Geïnspireerd door Alchemy voor Android door Andrey Zaikin
CheatTitle=Toon alle beschikbare elementen
HintTitle=Hints
HintDescription=Probeer
HintFrom=te maken van
HintClose=Klik binnen scherm om te sluiten
LanguageTitle=Taal
LanguageDescription=Selecteer taal
LanguageButton=Selecteer {0} als nieuwe taal
HeaderSaves=Opslaan
HeaderLanguage=Taal
HeaderSettings=Instellingen
HeaderCheats=Cheats
HeaderCredits=Credits
SavesInfoLine=Het spel word automatisch opgeslagen als je afsluit en geladen als je start.\n\nJe kan opslaan en laden van een andere lokatie dan standaard.\n\nJe kan ook het gehele spel resetten en opnieuw beginnen.\n
ButtonSave=Opslaan
ButtonLoad=Laden
ButtonReset=Reset
SettingCombineNew=Alleen nieuwe elementen combineren (negeer reeds gevonden elementen)
SettingTapCombine=Klik om te combineren (niet slepen, klik op 1ste element, dan op 2de element)
MoreTitle=Meer opties
ResetProgressWarning=Je staat op het punt om al je gevonden elementen te verwijderen. Weet je het zeker?\n\nHet is aanbevolen om eerst je huidige gevonden elementen op te slaan.\n\nGevonden elementen wissen??
ShowTimer=Toon Speeltijd (totaal verstreken tijd)
DesktopHint2=Klik op wissen om alle elementen te verwijderen
DesktopHint3=Ctrl + muisklik + Delete om één element te verwijderen
DesktopHint4=Dubbelklik op element om deze te kopieëren
DesktopHint5=Dubbelklik op scherm om basiselementen te verkrijgen
DesktopHint6=Gebruik knop meer voor instellingen
ElementsListHint1=Dubbelklikken om op hoofdscherm te zetten
ElementsListHint2=Sleep naar hoofdscherm
ElementsListHint3=Sommige elementen zijn niet te combineren
ElementsListHint4=Type een naam om te filteren
ButtonClear=Wissen
VictoryTitle=Overwinning
VictoryConcrats=Gefeliciteerd !
VictoryDescription=Je hebt alle elementen gevonden !