NonTerminalsHint=Eléments débloqués {0}/{1}
NonTerminalsSearchHint=Tapez ici pour filtrer les éléments
TerminalsHint=Eléments Aboutis
ButtonHint=Indice
ButtonWiki=Wiki
ButtonMore=Plus
ButtonHelp=Aide
ButtonAbout=A propos
DesktopHint=Déposez les éléments ici pour les combiner
TrashHint=Déposez les éléments ici pour les supprimer
HelpTitle=Aide
HelpLine1=Tu commences avec quatre éléments basiques : le feu, l'air, l'eau et la terre. Combine les pour obtenir de nouveaux éléments. Tu as gagné quand tu as débloqué tous les éléments.\n\n
HelpLine2=Vous pouvez déplacer les éléments de la réserve à gauche dans la zone centrale. Superposez deux éléments pour les combiner. Certains éléments sont aboutis, ils ne peuvent plus être combinés. Ils sont visibles dans la seconde réserve mais ne peuvent pas être déplacés dans la zone centrale. Vous pouvez aussi ajouter des éléments à la zone centrale en double-cliquant dessus.\n\n
HelpLine3=Pour retirer un éléments de la zone centrale, déplacez le sur la corbeille. Pour retirer tous les éléments de la zone centrale, double-cliquez sur la réserve. Vous pouvez aussi supprimer un élément en le selectionnant avec la souris tout en appuyant sur Controle et Supprimer.\n\n
HelpLine4=Double-cliquez sur un élément de la zone centrale pour le multiplier. Double-cliquez sur un espace vide de la zone centrale pour y ajouter les quatre éléments de base.\n\n
AboutTitle=A propos de Alchemy
AboutLine1=Alchemy {0} pour Windows\n
AboutLine2=Créé par Marius Bancila\n
AboutLine3=Copyright (c) 2010-2011 Marius Bancila\n
AboutLine4=Visitez www.mariusbancila.ro\n
AboutLine5=Inspiré de Alchemy pour Android par Andrey Zaikin
CheatTitle=Montrer tous les éléments disponibles
HintTitle=Indices
HintDescription=Essayez de créer
HintFrom=A partir de
HintClose=Cliquez pour fermer la fenêtre
LanguageTitle=Langue
LanguageDescription=Selectionnez une language
LanguageButton=Selectionner {0} comme nouvelle language
HeaderSaves=Sauvegarder
HeaderLanguage=Langues
HeaderSettings=Réglages
HeaderCheats=Tricher
HeaderCredits=Crédits
SavesInfoLine=Votre progression dans le jeu est automatiquement sauvegardée quand vous fermez le jeu et chargée quand vous l'ouvrez.\n\nVous pouvez enregistrer ou charger votre progression vers ou depuis un autre fichier que celui par défaut.\n\nVous pouvez aussi réinitialiser votre progression et tout recommencer.\n
ButtonSave=Sauvegarder
ButtonLoad=Charger
ButtonReset=Réinitialiser
SettingCombineNew=Combiner seulement les nouveautés (Ignore les combinaisons déjà découvertes)
SettingTapCombine=Sélectionner pour combiner (ne déplacez plus, sélectionnez le premier élément puis le deuxième)
MoreTitle=Plus d'options
ResetProgressWarning=Vous êtes sur le point de supprimer toute votre progression jusqu'ici. Etes-vous sûr de vouloir le faire ?\n\nIl est recommandé de sauvegardé votre progression actuelle avant de réinitialiser.\n\nVoulez-vous réinitialiser?
ShowTimer=Temps de jeu (temps total écoulé)
DesktopHint2=Clique sur effacer pour tout supprimer
DesktopHint3=Ctrl + clique souris + suppr pour supprimer un élément
DesktopHint4=Double clique sur un élément pour le dédoubler
DesktopHint5=Double clique sur la fenêtre centrale pour obtenir les éléments basiques
DesktopHint6=Utilise le bouton Plus pour les options
ElementsListHint1=Double clique pour mettre dans la fenêtre centrale
ElementsListHint2=Fais glisser et lâche sur la fenêtre centrale
ElementsListHint3=Certains éléments ne peuvent pas être combinés
ElementsListHint4=Tape un mot pour filtrer la liste.
ButtonClear=Effacer
VictoryTitle=Victory
VictoryCongrats=Congratulations!
VictoryDescription=You have unlocked all the available elements!