NonTerminalsHint=Freigespielte Elemente {0}/{1}
NonTerminalsSearchHint=Elemente suchen
TerminalsHint=Finale Elemente
ButtonHint=Hinweis
ButtonWiki=Wiki
ButtonMore=Weitere
ButtonHelp=Hilfe
ButtonAbout=Info
DesktopHint=Zum Kombinieren Elemente hierher ziehen
TrashHint=Zum Entfernen Element hierher ziehen
HelpTitle=Hilfe
HelpLine1=Du beginnst mit vier Grundelementen: Feuer, Luft, Wasser und Erde. Kombiniere sie um neue Elemente zu erhalten. Das Spiel endet, wenn du alle Elemente entdeckt hast.\n\n
HelpLine2=Du kannst Elemente aus dem linken Fenster in die mittlere Arbeitsfläche ziehen. Ziehe dort zwei Elemente übereinander um sie zu kombinieren. Einige Elemente sind finale Elemente, d.h. sie können nicht mehr kombiniert werden. Sie werden unten links angezeigt und können nicht in den Arbeitsbereich gezogen werden. Elemente aus der Liste können auch durch einen Doppelklick dem Arbeitsbereich hinzugefügt werden.\n\n
HelpLine3=Um ein Element vom Desktop zu entfernen, ziehe es einfach über den Papierkorb. Um alle Elemente vom Desktop zu entfernen reicht ein Doppelklick auf den Papierkorb. Man kann auch mehrere Elemente löschen, indem man sie mit der Maus auswählt und gleichzeitig die STRG-Taste gedrückt hält. Danach die Entfernen-Taste drücken.\n\n
HelpLine4=Doppelklicke auf ein Element im Arbeitsbereich um es zu duplizieren. Ein Doppelklick auf einen leeren Bereich des Desktops erzeugt die vier Grundelemente.\n\n
AboutTitle=Über Alchemy
AboutLine1=Alchemy {0} für Windows\n
AboutLine2=Autor: Marius Bancila\n
AboutLine3=Copyright (c) 2010-2011 Marius Bancila\n
AboutLine4=Webseite: www.mariusbancila.ro\n
AboutLine5=Inspiriert von Alchemy für Android von Andrey Zaikin
CheatTitle=Zeige alle erhältlichen Elemente
HintTitle=Hinweise
HintDescription=Versuche herzustellen:
HintFrom=aus
HintClose=Hineinklicken um das Hinweisfenster zu schließen
LanguageTitle=Sprache
LanguageDescription=Sprache wählen
LanguageButton=Wähle {0} als neue Sprache
HeaderSaves=Gespeichert
HeaderLanguage=Sprache
HeaderSettings=Einstellungen
HeaderCheats=Cheats
HeaderCredits=Danksagung
SavesInfoLine=Der Spielstand wird automatisch gespeichert wenn das Spiel beendet wird. Beim erneuten Öffnen wird es wieder geladen.\n\nDer Fortschritt kann auch in eine andere Datei gespeichert bzw. von einer anderen Datei geladen werden als von der Default-Datei.\n\nEs ist auch möglich den Spielstand zurückzusetzen und von vorne zu beginnen.\n
ButtonSave=Speichern
ButtonLoad=Laden
ButtonReset=Reset
SettingCombineNew=Nur neue Elemente kombinieren (bereits entdeckte Verbindungen ignorieren)
SettingTapCombine=Durch Klicken kombinieren (nicht ziehen, erstes Element anklicken und dann Zweites.)
MoreTitle=Mehr Optionen
ResetProgressWarning=Du bist gerade dabei den gesamten bisherigen Spielstand zu löschen. Bist du sicher?\n\nEs wird empfohlen, dass du vor dem Reset den aktuellen Zustand speicherst.\n\nWirklich zurücksetzen?
ShowTimer=Timer anzeigen (gesamte Spielzeit)
DesktopHint2=Klicken Sie auf Löschen, um alle löschen
DesktopHint3=Ctrl + mausklick + Delete auf ein Element löschen
DesktopHint4=Doppelklicken Sie auf Element klicken, um es doppelt
DesktopHint5=Doppelklicken Sie auf dem Desktop für Grundelemente
DesktopHint6=Mit der Taste Weitere für die Einstellungen
ElementsListHint1=Doppelklicken Sie auf Desktop bringen
ElementsListHint2=Drag & Drop auf den Desktop
ElementsListHint3=Einige Elemente können nicht kombiniert werden
ElementsListHint4=Geben Sie einen Namen für die Liste filtern
ButtonClear=Löschen
VictoryTitle=Victory
VictoryCongrats=Congratulations!
VictoryDescription=You have unlocked all the available elements!