NonTerminalsHint=אלמנטים זמינים {1}/{0}
NonTerminalsSearchHint=הקלד כאן על מנת לסנן אלמנטים
TerminalsHint=אלמנטים סופיים
ButtonHint=רמז
ButtonWiki=Wiki
ButtonMore=עוד
ButtonHelp=עזרה
ButtonAbout=אודות
DesktopHint=גרור אלמנטים לכאן על מנת לשלבם
TrashHint=גרור אלמנטים לכאן על מנת למחוק
HelpTitle=עזרה
HelpLine1=התחל עם ארבעה אלמנטים בסיסיים: אש, אוויר, מים ואדמה. שלב ביניהם על מנת ליצור אלמנטים חדשים. המשחק מסתיים כאשר נמצאו כל האלמנטים.\n\n
HelpLine2=יש לגרור אלמנטים מהפאנל השמאלי לפאנל המרכזי - שולחן העבודה. גרור שתי אלמנטים אחד על השני על מנת לשלבם. ישנם אלמנטים סופיים, אותם לא ניתן לשלב עוד, הם מופיעים בפאנל השמאלי התחתון. ניתן להוסיף אלמנטים לשולחן העבודה על ידי לחיצה כפולה עליהם.\n\n
HelpLine3=כדי לנקות את שולחן העבודה מכל האלמנטים יש ללחוץ לחיצה כפולה על סימן פח האשפה.\n\n
HelpLine4=לחיצה כפולה על אלמנט תשכפל אותו, לחיצה כפולה על שטח ריק בשולחן העבודה תוסיף את ארבעת האלמנטים הבסיסיים.\n\n
AboutTitle=אודות אלכימיה
AboutLine1=Alchemy {0} for Windows\n
AboutLine2=Created by Marius Bancila\n
AboutLine3=Copyright (c) 2010-2011 Marius Bancila\n
AboutLine4=Visit at www.mariusbancila.ro\n
AboutLine5=Inspired by Alchemy for Android by Andrey Zaikin
CheatTitle=הצג את כל האלמנטים הקיימים
HintTitle=רמזים
HintDescription=נסה ליצור
HintFrom=מ
HintClose=הקש על מנת לסגור את חלון הטיפים
LanguageTitle=שפה
LanguageDescription=בחר שפה
LanguageButton=בחר {0} כשפה חדשה
HeaderSaves=שמורים
HeaderLanguage=שפה
HeaderSettings=הגדרות
HeaderCheats=צ'יטים
HeaderCredits=תודות
SavesInfoLine=\nהמשחק נשמר באופן אוטומטי בעת היציאה.\n\nניתן לטעון משחק מקובץ שנשמר במעוד מועד.\n\nניתן לאפס את המשחק ולהתחיל מחדש.
ButtonSave=שמירה
ButtonLoad=טעינה
ButtonReset=איפוס
SettingCombineNew=שלב רק אלמנטים חדשים (התעלם מאלמנטים שכבר גיליתי)
SettingTapCombine=לחץ כדי לשלב (אל תגרור, לחץ על אלמנט ראשון ואז על האלמנט השני)
MoreTitle=אפשרויות נוספות
ResetProgressWarning=אתה עומד לאפס את התקדמותך עד לשלב זה. האם אתה בטוח שברצונך לבצע פעולה זו?\n\nמומלץ לשמור את התקדמותך לפני האיפוס.\n\nהאם ברצונך לאפס?
ShowTimer=הצג טיימר
DesktopHint2=לחץ על איזור ריק כדי לנקות הכל
DesktopHint3=החזק את לחצן ctrl ואז לחץ על אלמנט על מנת למחוק אותו.
DesktopHint4=לחץ לחיצה כפולה על אלמנט כדי לשכפלו.
DesktopHint5=לחץ לחיצה כפולה על שולחן העבודה כדי להציג את האלמנטים הבסיסיים.
DesktopHint6=לחץ על לחצן עוד להגדרות נוספות
ElementsListHint1=לחיצה כפולה כדי להעביר לשולחן עבודה
ElementsListHint2=גרור לשולחן העבודה
ElementsListHint3=ישנם אלמנטים שלא ניתן לשלב
ElementsListHint4=הקש מילה כדי לסנן את הרשימה
ButtonClear=נקה
VictoryTitle=ניצחת!
VictoryCongrats=מזל טוב!
VictoryDescription=מצאת את כל האלמנטים האפשריים!