NonTerminalsHint=Felfedezett elemek {0}/{1}
NonTerminalsSearchHint=Ide írj az elemek szűréséhez
TerminalsHint=Vég elemek
ButtonHint=Tipp
ButtonWiki=Wiki
ButtonMore=Opciók
ButtonHelp=Segítség
ButtonAbout=Névjegy
DesktopHint=Húzza ide az elemeket a kombináláshoz
TrashHint=Húzza ide az elemet az eltávolításhoz
HelpTitle=Segítség
HelpLine1=A négy alapelemmel kezdesz: tűz, levegő, víz és föld. Kombináld őket, az új elemek felfedezéséhez. A játéknak vége ha minden elemet felfedeztél.\n\n
HelpLine2=A bal felső panelről húzhatsz át elemeket a középső területre. Húzz egymásra két elemet a kombináláshoz. Néhány elem vég elem, amelyet már nem tudsz kombinálni, ezek a bal alsó panelon vannak és nem mozdíthatóak. Ha a bal felső panelon valamelyik elemre duplán kattintasz, akkor az hozzáadódik a kombinálható elemekhez.\n\n
HelpLine3=Az elem eltávolításához húzd be azt a szemetesbe. Minden elem eltávolításához duplán kattints a szemetesen. Úgy is törölhetsz elemeket, hogy kiválasztod őket az egérrel miközben nyomva tartod a CTRL billentyűt, majd lenyomod a Delete-t.\n\n
HelpLine4=Ha a középső panelon lévő elemeken duplán kattintasz, akkor megduplázhatod őket. Ha a középső panelon üres területen kattintasz duplán, a négy alapelemet hozod elő.\n\n
AboutTitle=Az Alchemy-ról
AboutLine1=Alchemy {0} for Windows\n
AboutLine2=Készítette: Marius Bancila\n
AboutLine3=Copyright (c) 2010-2011 Marius Bancila\n
AboutLine4=Látogasd meg a www.mariusbancila.ro weboldalt.\n
AboutLine5=Inspirálta az Android operációs rendszerre fejlesztett Alchemy, melyet Andrey Zaikin készített.
CheatTitle=Az összes elem mutatása
HintTitle=Tippek
HintDescription=Próbálj meg
HintFrom=-t készíteni a következőből:
HintClose=Kattints ide a tipp ablak bezárásához
LanguageTitle=Nyelv
LanguageDescription=Nyelv kiválasztása
LanguageButton={0} legyen az új nyelv
HeaderSaves=Mentések
HeaderLanguage=Nyelv
HeaderSettings=Beállítások
HeaderCheats=Csalások
HeaderCredits=Készítők
SavesInfoLine=Az aktuális állapot elmentésre kerül kilépésnél és betöltődik a játék indításánál.\n\nElmentheted és betöltheted az aktuális állapotot, vagy kezdhetsz új játékot.\n
ButtonSave=Mentés
ButtonLoad=Betöltés
ButtonReset=Alaphelyzet
SettingCombineNew=Csak új elemek létrehozása (figyelmen kívül hagyja a már felfedezett elemeket)
SettingTapCombine=Kombinálás kijelöléssel (nem húzással, hanem az első majd a második elemre való kattintással kombinál)
MoreTitle=További opciók
ResetProgressWarning=Arra készülsz, hogy töröld az jelenlegi játék állást. Biztosan ezt akarod?\n\nÚj játék indítása előtt ajánlott menteni a jelenlegi állapotot.\n\nÚj játék indítása?
ShowTimer=Idő megjelenítése (összes eltelt idő)
DesktopHint2=Kattints a Törlés-re az összes törléséhez
DesktopHint3=CTRL + kattintás az egérrel + Delete-vel törölhetsz elemeket
DesktopHint4=Kattints kétszer egy elemre a megduplázásához
DesktopHint5=Kattints kétszer az asztalra a négy alapelem hozzáadásához
DesktopHint6=A Tovább gombbal érheted el a beállításokat
ElementsListHint1=Kattints kétszer egy elemre hogy a munka asztalra kerüljön
ElementsListHint2=Fogd és vidd módszerrel az asztalra tudod tenni az elemet
ElementsListHint3=Néhány elem nem kombinálható
ElementsListHint4=Írj be egy nevet a szűréshez
ButtonClear=Törlés
VictoryTitle=Győzelem
VictoryCongrats=Gratulálok!
VictoryDescription=Az összes lehetséges elemet megtaláltad!