NonTerminalsHint=Elemen Yang Sudah Ditemukan {0}/{1}
NonTerminalsSearchHint=Ketik Disini Untuk Memfilter Elemen
TerminalsHint=Elemen Yang Sudah Tidak Bisa Digabung Lagi
ButtonHint=Petunjuk
ButtonWiki=Wiki
ButtonMore=Opsi
ButtonHelp=Bantuan
ButtonAbout=Tentang
DesktopHint=Seret Disini Untuk Menggabung Elemen
TrashHint=Seret Disini Untuk Menghapus
HelpTitle=Bantuan
HelpLine1=Kamu Mulai Dengan Empat Elemen Dasar: Api, Udara, Air, Tanah . Gabungkan Elemen Tersebut Untuk Mendapatkan Elemen Yang Baru, Game Akan Tamat Apabila Semua Elemen Telah Ditemukan\n\n
HelpLine2=Kamu Bisa Menyeret Elemen Dari Panel Kiri Ke Area Tengah. Seret Dua Elemen Untuk Menggabung Elemen Tersebut. Beberapa Elemen Ada Yang Tidak Bisa Digabung, Elemen Tersebut Tidak Bisa Digabung Dengan Yang Lain. Elemen Tersebut Ditandai Dengan Ikon Merah Kecil Dibawah Kanan Dan Tidak Bisa Diseret Ke Area Tengah. Kamu Juga Bisa Memindahkan Elemen Dari Panel Kiri Ke Area Tengah Dengan Mengklik Dua Kali Elemen Tersebut .\n\n
HelpLine3=Untuk Mengahpus Semua Elemen Dari Area Tengah Klik Dua Kali Pada Ikon Tong Sampah  . Kamu Juga Bisa Menghapus Elemen Dengan Mengklik Elemen Tersebut Lalu Tahan Tombol Ctrl sambil Menekan Tombol Delete\n\n
HelpLine4=Klik Dua Kali Pada Sebuah Elemen Di Area Tengah Untuk Menggandakan Elemen Tersebut . Klik Dua Kali Di Bagian Kosong Dari Area Tengah Untuk Memunculkan Empat Elemen Dasar.\n\n
AboutTitle=Tentang Alchemy
AboutLine1=Alchemy {0} for Windows\n
AboutLine2=Dibuat Oleh Marius Bancila\n
AboutLine3=Hak Cipta (c) 2010-2011 Marius Bancila\n
AboutLine4=Kunjungi www.mariusbancila.ro\n
AboutLine5=Terinspirasi Oleh Alchemy for Android Buatan Andrey Zaikin
CheatTitle=Tunjukan Semua Elemen Yang Tersedia
HintTitle=Petunjuk
HintDescription=Coba Buat
HintFrom=Dari
HintClose=Klik Didalam Window Untuk Menutup Window Ini
LanguageTitle=Bahasa
LanguageDescription=Pilih Bahasa
LanguageButton=Pilih {0} Sebagai Bahasa Baru
HeaderSaves=Simpan
HeaderLanguage=Bahasa
HeaderSettings=Opsi
HeaderCheats=Cheats
HeaderCredits=Credits
SavesInfoLine=Perkembangan Game-mu Telah Tersimpan Secara Otomatis Saat Game Ditutup Dan Akan Dimuat Kembali Saat Dimainkan Kembali.\n\nKamu Bisa Menyimpan Dan Memuat Perkembangan Game Dari Dokemun Selain Yang Standar .\n\nKamu Juga Bisa Mengulang Seluruh Perkembangan Game-mu Dan Memulai Dari Awal.\n
ButtonSave=Simpan
ButtonLoad=Muat
ButtonReset=Ulang
SettingCombineNew=Hanya Gabungkan Yang Baru (Abaikan Bila Kombinasi Telah Ditemukan)
SettingTapCombine=Klik Untuk Menggabung (Jangan Diseret, Klik Elemen Pertama Lalu Klik Elemen Kedua)
MoreTitle=Opsi
ResetProgressWarning=Kamu Akan Menghapus Seluruh Perkembangan Game-mu. Apa Kau Yakin?\n\nDirekomendasikan Untuk Menyimpan Perkembangan Game-mu Sebelum Kamu Mengulang .\n\nApakah Kamu Akan Mengulang ?
ShowTimer=Waktu (total waktu yang terlewat)
DesktopHint2=Klik Hapus Untuk Menghapus Semua
DesktopHint3=Ctrl + Klik Kiri + Delete Untuk Menghapus Sebuah Elemen
DesktopHint4=Klik Dua Kali Untuk Menggandakan Elemen Tersebut
DesktopHint5=Klik Dua Kali Di Area Tengah Untuk Memunculkan Empat Elemen Dasar
DesktopHint6=Gunakan tombol opsi Untuk Men-Setting
ElementsListHint1=Klik Dua Kali Untuk Meletakan Di Area Tengah
ElementsListHint2=Seret Dan Letak Di Area Tengah
ElementsListHint3=Beberapa Elemen Tidak Bisa Digabungkan
ElementsListHint4=Ketik Nama Untuk Menfilter Daftar
ButtonClear=Hapus
VictoryTitle=Victory
VictoryCongrats=Selamat!
VictoryDescription=Kamu Telah Menemukan Semua Elemen Yang Ada!