NonTerminalsHint=Elementi sbloccati {0}/{1}
NonTerminalsSearchHint=Scrivi qui per filtrare gli elementi
TerminalsHint=Elementi terminali
ButtonHint=Aiuto
ButtonWiki=Wiki
ButtonMore=Opzioni
ButtonHelp=Guida
ButtonAbout=Info su
DesktopHint=Trascina gli elementi qui per combinarli
TrashHint=Trascina un elemento qui per rimuoverlo
HelpTitle=Guida
HelpLine1=Si inizia con quattro elementi di base: Fuoco, Aria, Acqua e Terra Combinali per ottenere nuovi elementi. Il gioco finisce quando hai sbloccato tutti gli elementi.\n\n
HelpLine2=Puoi trascinare gli elementi dal pannello di sinistra nell'area centrale. Combinali trascinandoli uno sopra l'altro. Alcuni elementi sono terminali, e non possono più essere combinati: essi vengono elencati in un pannello secondario e non possono essere trascinati. Puoi aggiungere elementi all'area di gioco anche facendo doppio clic su di essi.\n\n
HelpLine3=Per rimuovere un elemento dall'area di gioco trascinalo sul cestino, per rimuovere tutti gli elementi dall'area di gioco fai doppio clic sul cestino. Puoi anche rimuovere gruppi di elementi selezionandoli uno ad uno mentre tieni premuto il tasto CTRL, e rimuovendoli premendo CANC.\n\n
HelpLine4=Fai doppio clic su un elemento nell'area di gioco per duplicarlo, fai doppio clic su uno spazio vuoto nell'area di gioco per riportare in gioco i quattro elementi di base.\n\n
AboutTitle=Informazioni su Alchemy
AboutLine1=Alchemy {0} per Windows\n
AboutLine2=Scritto da Marius Bancila\n
AboutLine3=Copyright (c) 2010-2011 Marius Bancila\n
AboutLine4=Vienimi a trovare su www.mariusbancila.ro\n
AboutLine5=Ispirato da Alchemy for Android by Andrey Zaikin
CheatTitle=Mostra tutti gli elementi disponibili
HintTitle=Aiuto
HintDescription=Prova a ottenere
HintFrom=Da
HintClose=Clicca all'interno per chiudere l'aiuto
LanguageTitle=Lingua
LanguageDescription=Seleziona lingua
LanguageButton=Seleziona {0} come nuova lingua
HeaderSaves=Salva
HeaderLanguage=Lingua
HeaderSettings=Opzioni
HeaderCheats=Trucchi
HeaderCredits=Riconoscimenti
SavesInfoLine=Il progresso di gioco viene salvato automaticamente quando chiudi il gioco e ricaricato quando lo lanci.\n\nPuoi memorizzare il progresso di gioco o caricarlo da un altro file.\n\nPuoi anche cancellare tutti i progressi e ripartire dall'inizio.\n
ButtonSave=Salva
ButtonLoad=Carica
ButtonReset=Cancella tutto
SettingCombineNew=Combina solo nuovi (non ripresentare le combinazioni già ottenute)
SettingTapCombine=Combina cliccando (non trascinare, clicca sul primo e poi sul secondo elemento)
MoreTitle=Opzioni avanzate
ResetProgressWarning=Stai per cancellare completamente i progressi di gioco. Confermi di volerlo fare?\n\nTi suggerisco di salvare i progressi in un file separato prima di cancellare tutto.\n\nVuoi ripartire da zero?
ShowTimer=Mostra cronometro (tempo di gioco totale)
DesktopHint2=Click on Clear to delete all
DesktopHint3=Ctrl + mouse click + Delete to delete an element
DesktopHint4=Double click on element to double it
DesktopHint5=Double click on desktop for basic elements
DesktopHint6=Use button More for settings
ElementsListHint1=Double click to put on desktop
ElementsListHint2=Drag and drop to desktop
ElementsListHint3=Some elements cannot be combined
ElementsListHint4=Type a name to filter the list
ButtonClear=Clear
VictoryTitle=Victory
VictoryCongrats=Congratulations!
VictoryDescription=You have unlocked all the available elements!