NonTerminalsHint=Odblokowane elementy {0}/{1}
NonTerminalsSearchHint=Pisz tutaj, by filtrować elementy
TerminalsHint=Elementy końcowe
ButtonHint=Podpowiedź
ButtonWiki=Wiki
ButtonMore=Więcej
ButtonHelp=Pomoc
ButtonAbout=O grze
DesktopHint=Przeciągnij elementy tutaj, aby je połączyć
TrashHint=Przeciągnij element tutaj, aby go usunąć
HelpTitle=Pomoc
HelpLine1=Zaczynasz z czterema podstawowymi żywiołami: ogniem, powietrzem, wodą i ziemią. Połącz je w celu uzyskania nowych elementów. Zakończysz grę, gdy odblokujesz wszystkie elementy.\n\n
HelpLine2=Możesz przeciągać elementy z panelu po lewej stronie do obszaru w centrum. Połóż dwa elementy na sobie, aby je połączyć. Niektóre elementy są końcowe, nie można ich więcej łączyć. Są one wyświetlane z ikoną blokady i nie mogą być przeciągane na obszar pulpitu. Można również dodawać na pulpit elementy z listy poprzez podwójne kliknięcie na nich.\n\n
HelpLine3=Aby usunąć wszystkie elementy z pulpitu, kliknij dwukrotnie na ikonie śmietnika. Można również usunąć elementy wybierając je za pomocą myszy, przytrzymując klawisz Ctrl, a następnie naciskając klawisz Delete.\n\n
HelpLine4=Kliknij dwukrotnie na elemencie z pulpitu, aby go podwoić. Kliknij dwukrotnie na pustym miejscu na pulpicie, by przywołać cztery podstawowe żywioły.\n\n
AboutTitle=O Alchemy
AboutLine1=Alchemy {0} dla Windows\n
AboutLine2=Stworzony przez Marius Bancila\n
AboutLine3=Copyright (c) 2010-2011 Marius Bancila\n
AboutLine4=Odwiedź stronę www.mariusbancila.ro\n
AboutLine5=Zainspirowany przez Alchemy dla Androida Andreya Zaikina
CheatTitle=Pokaż wszystkie dostępne elementy
HintTitle=Podpowiedzi
HintDescription=Spróbuj zrobić
HintFrom=z
HintClose=Kliknij wewnątrz, aby zamknąć okno z podpowiedzią
LanguageTitle=Język
LanguageDescription=Wybierz język
LanguageButton=Wybierz {0} jako nowy język
HeaderSaves=Zapisy
HeaderLanguage=Język
HeaderSettings=Ustawienia
HeaderCheats=Kody
HeaderCredits=Podziękowania
SavesInfoLine=Twój postęp w grze jest zapisywany automatycznie po zamknięciu gry i wczytywany w czasie uruchomienia.\n\nMożesz również zapisać lub wczytać postęp do lub z pliku innego niż domyślny.\n\nMożesz również zresetować cały postęp i zacząć grę od nowa.\n
ButtonSave=Zapisz
ButtonLoad=Wczytaj
ButtonReset=Resetuj
SettingCombineNew=Łącz tylko nowe (ignoruj już odkryte kombinacje)
SettingTapCombine=Kliknij, by połączyć (nie przeciągaj, kliknij pierwszy element, a następnie drugi)
MoreTitle=Więcej opcji
ResetProgressWarning=Zamierzasz usunąć cały dotychczasowy postęp. Czy na pewno chcesz to zrobić?\n\nZaleca się zapisać bieżący postęp przed dokonaniem resetu.\n\nCzy chcesz zresetować?
ShowTimer=Wyświetlaj czas (całkowity czas gry)
DesktopHint2=Kliknij Wyczyść, aby usunąć wszystkie
DesktopHint3=Ctrl + kliknięcie myszy + Delete, aby usunąć element
DesktopHint4=Kliknij dwukrotnie na elemencie, aby go podwoić
DesktopHint5=Kliknij dwukrotnie na pulpicie, by stworzyć podstawowe żywioły
DesktopHint6=Użyj przycisku Więcej, aby wejść w ustawienia
ElementsListHint1=Kliknij dwukrotnie, by umieścić na pulpicie
ElementsListHint2=Przeciągnij i upuść na pulpit
ElementsListHint3=Niektóre elementy nie mogą być połączone
ElementsListHint4=Wpisz nazwę, aby przefiltrować listę
ButtonClear=Wyczyść
VictoryTitle=Zwycięstwo
VictoryCongrats=Gratulacje!
VictoryDescription=Właśnie odblokowałeś wszystkie dostępne elementy!