NonTerminalsHint=Elementos destravados {0}/{1}
NonTerminalsSearchHint=Digite aqui para filtrar os elementos
TerminalsHint=Elementos terminais
ButtonHint=Dica
ButtonWiki=Wiki
ButtonMore=Mais
ButtonHelp=Ajuda
ButtonAbout=Sobre
DesktopHint=Arraste os elementos aqui para combinar
TrashHint=Arraste os elementos aqui para remover
HelpTitle=Ajuda
HelpLine1=Você começa com quatro elementos básicos: fogo, ar, água e terra. Combine-os para obter novos elementos. Você finaliza o jogo quando destravar todos os elementos.\n\n
HelpLine2=Você pode arrastar elementos do painel esquerdo para dentro da área central. Arraste dois elementos juntos para combiná-los. Alguns elementos são terminais, eles não poderão mais ser combinados. Eles serão exibidos em um segundo painel e não poderão ser arrastados para a área de trabalho. Você também poderá adicionar elementos da lista para a área de trabalho clicando duas vezes nele.\n\n
HelpLine3=Para remover um elemento da área de trabalho arraste-o para cima da lixeira. Para remover todos os elementos da área de trabalho clique duas vezes na lixeira. Você também pode excluir elementos selecionando-os com o mouse enquanto pressiona a tecla Control (CTRL) e, em seguida, pressionando a tecla Delete (DEL).\n\n
HelpLine4=Clique duas vezes em um elemento na área de trabalho para duplicá-lo. Clique duas vezes em um espaço vazio na área de trabalho para trazer os quatro elementos básicos.\n\n
AboutTitle=Sobre o Alchemy
AboutLine1=Alchemy {0} para Windows\n
AboutLine2=Criado por Marius Bancila\n
AboutLine3=Todos os Direitos Reservados (R) 2010-2011 Marius Bancila\n
AboutLine4=Visite www.mariusbancila.ro\n
AboutLine5=Inspirado no Alchemy para Android do Andrey Zaikin
CheatTitle=Exibir todos os elementos disponíveis
HintTitle=Dicas
HintDescription=Tente criar
HintFrom=a partir de
HintClose=Clique dentro para fechar a janela da dica
LanguageTitle=Idioma
LanguageDescription=Selecione o idioma
LanguageButton=Selecionar {0} como o novo idioma
HeaderSaves=Jogos Salvos
HeaderLanguage=Idioma
HeaderSettings=Configuração
HeaderCheats=Cheats
HeaderCredits=Créditos
SavesInfoLine=Seu progresso de jogo é salvo automaticamente quando você fecha o jogo e carregado quando você inicia.\n\nVocê pode armazenar ou carregar o progresso para ou de outro arquivo diferente do padrão.\n\nVocê também pode reiniciar todo o seu progresso e iniciar tudo novamente.\n
ButtonSave=Salvar
ButtonLoad=Carregar
ButtonReset=Reiniciar
SettingCombineNew=Combinar somente novos elementos (ignorar combinações já descobertas)
SettingTapCombine=Selecionar para combinar (não arrastar, selecionar o 1º elemento e depois o 2º)
MoreTitle=Mais opções
ResetProgressWarning=Você está prestes a apagar todo o seu progresso realizado. Você tem certeza que quer fazer isto?\n\nÉ recomendado que você salve o seu progresso atual antes de reiniciar.\n\nVocê gostaria de reiniciar?
ShowTimer=Exibir cronômetro (tempo total decorrido)
DesktopHint2=Clique no Limpar para apagar todos
DesktopHint3=Ctrl + Clique do mouse + Delete para apagar um elemento
DesktopHint4=Clique duplo em um elemento para duplicá-lo
DesktopHint5=Clique duplo na área de trabalho para obter os elementos básicos
DesktopHint6=Use o botão Mais para configurações
ElementsListHint1=Clique duplo para colocá-lo na área de trabalho
ElementsListHint2=Arrastar e Soltar para a área de trabalho
ElementsListHint3=Alguns elementos não podem ser combinados
ElementsListHint4=Digite um nome para filtrar a lista
ButtonClear=Limpar
VictoryTitle=Vitória
VictoryCongrats=Parabéns!
VictoryDescription=Você destravou todos os elementos disponíveis!