NonTerminalsHint=Elemente descoperite {0}/{1}
NonTerminalsSearchHint=Introduce nume pentru filtrare
TerminalsHint=Elemente terminale
ButtonHint=Pont
ButtonWiki=Wiki
ButtonMore=Alte
ButtonHelp=Ajutor
ButtonAbout=Despre
DesktopHint=Trage elemente aici pentru a le combina
TrashHint=Trage elemente aici pentru a le sterge
HelpTitle=Ajutor
HelpLine1=Pornesti cu patru elemente de baza: pamant, apa, aer, foc. Combina-le pentru a obtine noi elemente. Termini cand descoperi toate elementele.\n\n
HelpLine2=Poti trage elemente din zona din stanga in zona centrala. Pune doua elemente unul peste altul pentru a le combina. Unele elemente sunt terminale, ele nu mai pot fi combinate. Acestea sunt afisate cu o icoana ce indica blocare si nu pot fi trase de aici in zona de lucru. Elemente neterminale pot fi de asemenea adaugate in zona de lucru cu dublu clic.\n\n
HelpLine3=Pentru a sterge toate elementele din zona de lucru fa un dublu clic pe cosul de gunoi. Se pot sterge elemente si selectandu-le cu mouseul tinand tasta Control apasata si apoi apasand tasta Delete.\n\n
HelpLine4=Pentru a duplica un element in zona de lucru fa un dublu clic pe el. Un dublu clic intr-o arie goala din zona de lucru va aduce acolo cele patru elemente primordiale.\n\n
AboutTitle=Despre Alchemy
AboutLine1=Alchemy {0} pentru Windows\n
AboutLine2=Creat de Marius Bancila\n
AboutLine3=Copyright (c) 2010-2011 Marius Bancila\n
AboutLine4=Viziteaza la www.mariusbancila.ro\n
AboutLine5=Inspirat din Alchemy pentru Android de Andrey Zaikin
CheatTitle=Afiseaza toate elementele disponibile
HintTitle=Ponturi
HintDescription=Incearca sa creezi
HintFrom=din
HintClose=Click inauntru pentru a inchide fereastra
LanguageTitle=Limba
LanguageDescription=Selecteaza limba
LanguageButton=Selecteaza {0} ca limba noua
HeaderSaves=Salvari
HeaderLanguage=Limba
HeaderSettings=Setari
HeaderCheats=Ponturi
HeaderCredits=Credite
SavesInfoLine=Progresul in joc este salvat automat cand inchizi jocul si reincarcat cand pornesti jocul.\n\nPoti salva sau incarca progresul in alt fisier decat cel implicit.\n\nPoti de asemenea sterge progresul actual si reincepe de la zero.\n
ButtonSave=Salveaza
ButtonLoad=Incarca
ButtonReset=Sterge
SettingCombineNew=Doar combinatii noi (ignora cele descoperite deja)
SettingTapCombine=Atinge pentru a combina (nu trage, atinge primul element apoi al doilea)
MoreTitle=Alte optiuni
ResetProgressWarning=Esti pe cale sa stergi intregul progres de pana acum. Esti sigur ca vrei sa faci acest lucru?\n\nEste recomandat sa salvezi progresul inainte de a sterge tot.\n\nDoresti sa stergi tot?
ShowTimer=Afiseaza timpul (total trecut de la inceput)
DesktopHint2=Clic pe Sterge pentru a sterge toate elementele.
DesktopHint3=Ctrl + clic + Delete pentru a sterge un element
DesktopHint4=Clic dublu pe un element pentru a-l dubla
DesktopHint5=Clic dublu pe desktop pentru a aduce elementele primare
DesktopHint6=Foloseste butonul Alte pentru setari
ElementsListHint1=Clic dublu pentru a pune pe desktop
ElementsListHint2=Trage elemente pe desktop
ElementsListHint3=Unele elemente nu pot fi combinate
ElementsListHint4=Introdu un nume pentru filtrare
ButtonClear=Sterge
VictoryTitle=Victorie
VictoryCongrats=Felicitari!
VictoryDescription=Ai descoperit toate elementele disponibile!