NonTerminalsHint=Dostupné objavy {0}/{1}
NonTerminalsSearchHint=Vyhladajte element
TerminalsHint=Terminal elements
ButtonHint=Nápoveda
ButtonWiki=Wiki
ButtonMore=Viac
ButtonHelp=Pomoc
ButtonAbout=O programe
DesktopHint=Sem pretiahnite pre kombinovanie
TrashHint=Sem pretiahnite pre vymazanie
HelpTitle=Pomoc
HelpLine1=Začínate so štyrmi základnými elementami: ohňom, vzduchom, vodou a zemou. Ich kombináciou získate ďalšie elementy. Hra končí keď sú objavené všetky.\n\n
HelpLine2=Môžete pretiahnuť elementy z ľavého panela do strednej časti (pracovnú plochu) Pretiehnite dva elementy na seba a tým ich skombinujete. Niektoré elementy sú však konečné a nemožno ich ďalej kombinovať. Sú zobrazené s blokovacou ikonkou vpravo dole a nejdú pretiahnuť na pracovnú plochu. Element je tiež možné pridať dvojklikom v zozname.\n\n
HelpLine3=Pre odstránenie elementu ho pretiahnite do koša. Pre odstránenie všetkých elementov z pracovnej plochy kliknite na kôš (vymazať). Elementy môžete tiež vymazať vybraním myšou spolu s klávesou CTRL a potom stlačiť klávesu Delete.\n\n
HelpLine4=Dvojklik na element na pracovnej ploche pre jeho zdvojenie. Dvojklikom na prázdne miesto na pracovnej ploche pre pridanie štyroch základných elementov.\n\n
AboutTitle=O Alchemy
AboutLine1=Alchemy {0} pre Windows\n
AboutLine2=Autor - Marius Bancila\n
AboutLine3=Copyright (c) 2010-2011 Marius Bancila\n
AboutLine4=Navštívte www.mariusbancila.ro\n
AboutLine5=Inšpirované Alchemy pre Android od Andrey Zaikin
CheatTitle=Ukáž všetky elementy
HintTitle=Rada
HintDescription=Skúste vytvoriť
HintFrom=z
HintClose=Kliknite do plochy pre zatvorenie tohoto okna
LanguageTitle=Jazyk
LanguageDescription=Zvoľte jazyk
LanguageButton=Zvoľte {0} ako nový jazyk
HeaderSaves=Uložené
HeaderLanguage=Jazyk
HeaderSettings=Nastavenia
HeaderCheats=Cheaty
HeaderCredits=Kredity
SavesInfoLine=Vaša hra je automaticky uložená keď skončíte a načítaná pri štarte\n\nJe možné hru uložiť a načítať aj z iného než základného súboru.\n\nMôžete tiež hru zresetovať a začať všetko od začiatku.\n
ButtonSave=Uložiť
ButtonLoad=Načítať
ButtonReset=Reset
SettingCombineNew=Kombinovať iba nové (ignorovať už objavené kombinácie)
SettingTapCombine=Kombinovať kliknutím (nepretahovať, kliknúť na prvý a potom druhý element
MoreTitle=Viac možností
ResetProgressWarning=Naozaj chcete aby sa váš súčasný pokrok kompletne vymazal?\n\nPred resetom je doporučené najprv uložiť aktuálny stav.\n\nSkutočne zresetovať?
ShowTimer=Zobraziť časomieru (celkový uplynutý čas)
DesktopHint2=Kliknite na Vymazať pre vymazanie všetkého
DesktopHint3=Ctrl + klik + Delete pre vymazanie elementu
DesktopHint4=Dvojklik na element pre zdvojenie
DesktopHint5=Dvojklik na plochu pre pridanie základných elementov
DesktopHint6=Použite tlačítko Viac pre nastavenia
ElementsListHint1=Dvojklik pre pridanie na plochu
ElementsListHint2=Chyťte a pretiahnite na plochu
ElementsListHint3=Niektoré elemnety nemožno kombinovať
ElementsListHint4=Napíšte meno pre filtrovanie zoznamu
ButtonClear=Vymazať
VictoryTitle=Víťazstvo
VictoryCongrats=Gratulujeme!
VictoryDescription=Máte vynájdené všetky dostupné elementy!