NonTerminalsHint=Elementos desbloqueados{0}/{1}
NonTerminalsSearchHint=Escribe aquí para filtrar elementos
TerminalsHint=Elementos terminales
ButtonHint=Pista
ButtonWiki=Wiki
ButtonMore=Más
ButtonHelp=Ayuda
ButtonAbout=Acerca de
DesktopHint=Arrastra elementos acá para combinarlos
TrashHint=Arrastra elementos acá para eliminarlos
HelpTitle=Ayuda
HelpLine1=Inicia con los 4 elementos básicos: fuego, aire, agua y tierra. Combínalos para obtener nuevos lementos. Has terminado cuando descubras todos los elementos.\n\n
HelpLine2=Puedes arrastrar elementos del panel izquierdo al área central. Arrastra dos elementos para combinarlos. Algunos elementos son terminales, esos ya no pueden ser combinados. Se ven con un ícono de bloqueo y no pueden ser arrastrados hacia el área de escritorio. Puedes también añadir elementos de la lista al escritorio haciendo doble clic en ellos.\n\n
HelpLine3=Para eliminar todos los elementos del escritorio, haz doble clic en el basurero. También puedes eliminar elementos seleccionándolos con el ratón mientras mantienes presionada la tecla Control y luego presionando Delete.\n\n
HelpLine4=Haz doble clic a un elemento en el escritorio para que se multiplique. Haz doble clic en un espacio vacio para crear los cuatro elementos básicos.\n\n
AboutTitle=Acerca de Alchemy
AboutLine1=Alchemy {0} para Windows\n
AboutLine2=Creado por Marius Bancila\n
AboutLine3=Copyright (c) 2010-2011 Marius Bancila\n
AboutLine4=Visíta www.mariusbancila.ro\n
AboutLine5=Inspirado en el juego Alchemy para Android de Andrey Zaikin
CheatTitle=Muestra todos los elementos disponibles.
HintTitle=Pistas
HintDescription=Intenta hacer
HintFrom=De
HintClose=Haz clic en esta ventana para cerrarla
LanguageTitle=Lenguaje
LanguageDescription=Selecciona lenguaje
LanguageButton=Selecciona {0} como nuevo lenguaje
HeaderSaves=Guardar
HeaderLanguage=Lenguaje
HeaderSettings=Configuración
HeaderCheats=Trucos
HeaderCredits=Créditos
SavesInfoLine=El progreso de tu juego es guardado automáticamente cuando cierras el juego y es cargado couando lo inicias.\n\n Puedes guardar o cargar el progreso de o hacia otro archivo distinto del que está por defecto.\n\n También puedes resetear todo tu progreso y comenzar de nuevo.\n
ButtonSave=Guardar
ButtonLoad=Cargar
ButtonReset=Resetear
SettingCombineNew=Combinar solamente nuevos(ignorar las combinaciones ya descubiertas)
SettingTapCombine=Clic para combinar(sin arrastrar, clic en el 1er elemento y luego en el 2º)
MoreTitle=Más opciones
ResetProgressWarning= Estás a punto de borrar todo tu progreso hasta ahora. Estás seguro que deseas hacer eso?\n\nIt es recomendable que guardes tu progreso antes de resetearlo.\n\nQuieres resetearlo?
ShowTimer=Mostrar contador (tiempo total transcurrido)
DesktopHint2=Clic en Clear para eliminarlo todo
DesktopHint3=Ctrl + clic + Delete para eliminar un elemento.
DesktopHint4=Doble clic en un elemento para duplicarlo.
DesktopHint5=Doble clic en el escritorio para los elemntos básicos.
DesktopHint6=usa el botón más para configurar
ElementsListHint1=Doble clic para llevarlo al escritorio
ElementsListHint2=Arrastra y déjalo sobre el escritorio.
ElementsListHint3=Algunos elemntos no pueden ser combinados.
ElementsListHint4=Escribe un nombre para filtrarlo de la lista.
ButtonClear=Limpiar
VictoryTitle=Victoria
VictoryCongrats=¡Felicidades!
VictoryDescription=¡Has desbloqueado todos los elementos disponibles!